144,105
157,18
17,73
57,81
148,114
157,108
104,97
132,42
44,14
118,101
aaaaa10111111010111111110111102210201212102102111100010211210111111011100110110111aa1111101101110110111101110010a11101011110101111111101101111011111101010101001
1101a11001110011111111111111111121001211212211211112121022101110110110111010111aaaa11011111111111111011111111111a00011111101111111111011111011111111001011101100
1001a01111110111110111111111102011122001102112211112210212000111111110111101110aaa111011101011111111010111111001a11111111111101111101111001010110111101111111110
1111aaa111111111110011111101122021122122102122110222121111000011111111111011111aa1011111111100111100111001010011aaaa11111111011111100111111010110111011111011111
111111a1111111111111010111101121121000102122212220110221110111110111010110111111a1111111111111111111111101111110111a10011111110101111110111011100111110111111111
111aaaa0101011111011110011110111110212010221211222121000012111011111101111010011a0111111111110111001111101111111111a11111101111010110111110111101111111101001101
111a1111111111111111111101111212001021100221221121220122122101110110111111111aaaa1111011111111110001111101011111111a01111111110110001001110111111111101111111111
110a0111101110110111100111011201021121120122120221201221011211011111111101111a1111011111111110110111011111111111111aaa110111111111011101111110111110111111111110
111a0111010001101110111111111201202202111112212221111212112210111111111111011a111110110111101001011111101aaaaaaaaaaaaa111111101111101111111011111111011110111111
101a0111010111011011101011010011222120210121120121111211012011011011010111111a111111111010101111110110aaaa110101111110110111011111011111011110111110110101011111
000aaa0111101111111111111111121212100221222121111111221212221110010100101101aa101111111011111001100000a100111111110101101111111111110111111111101011111100001111
11111a1111110111111111011111101121210112222022110211211111111011111111110111aaaaaaaaaa1111111111111111aaaaa11111110111111111011101110011101010111101101110100111
11111a1111011111111111110110012002221212102122101121210101000111111110111111111011111aaa11aaaaa11011011111a11110000111010111110110011011100111110111101111001111
0aaaaa110111110111111110110012202212201211111212101122201212110101010111110111110111011aaaa111a00111110111a11110100011011111111110110011111110011111110101101011
0a00111111011111111011111010101120122001010210011111112012101011110111100111110101001111111110a10111101111a11001111111010111010101010100111111101111111101111111
1aaaaaaaaaaaaaa1111111111000102222012201020011112122220222221101111111101011101111101111111111aaaaaaaa1111a11111110101011111111111011101011101110111111111100011
11111110001010a01101110011111122112111012122212221200011220010101000011011101101001101111111111111111aaaaaa11111111001011111111111111100110111110111011000100111
11111111111111a11011111011110111222220211111020222010222212111111111010100101011111110101011111110111aa011011101111111101111110011101111110101111111111111111111
10110111111111a1101111100011121222102112111122211221212011021111010110111111110001111111011111111100011111110111011111011111110110101111110110111110111110011110
11111101110111a1110111111111021221022202012012121111012211011110100101111110111111011110101011101111111111111011111111111001110011111101110011111111101111111111
11011101111110a1111111111111100022021121001121120101212122021111111111111111110111111110011111110111111111111110111111111111111111101110111111111111110111111111
111101001111aaa0001111011111111220021111112201111112111100201110101001100110111111101101111101111111111001111111010111111001101110111001111111011011001101101110
111111111101a111111111111110102002011121102221121202210211101111010101011011111010101011100111100110011011111101110111101011111101110111111111111111101111111110
111110011011a000011111111110101111222222012000220121202121121001011111011011110111100110111110011101110111101111000111011011111110101110010110101111111011101011
111101101111a111111101101111121200120100211101201001011122111111110101111110111111011110111111101001101011011111010111111111110111111111111110101111111001111111
011111111011a101110111101110102212101212222210221121212112211111111110110011111111111011110111111111111111011110011111111110110110111100111111001111011101101111
001110110110aaaa111100111111112211111020110211021201112002221110111011001101110001011101011111111001100101011101110001111111010110111111110111111101011111011101
101110111011111a111010111111011201220222111122221201122212101111011001111101111111111111111110111110110100111111101112021221012112102022121022010210000111101111
101111100111111a110111101101112122022220111212011022110210101110111111111011100111111100111011111111111011111111110112122120102212110122212112022121111101101111
101011111100111a111011010111121021200011121012021122001110111011111111111111111101111111111110001101111101110011111112110111202212211121201200210121110111111111
011111010011010a111001111110011111100011011111100001110111110101101111111111101011111011111001111111111111010111001111021112220202221221101112220110110011101111
011111101100111a111111111110111111000011111111111011111111011111111111001011011001011110111110100010110111111111111112210212220211111011111112212210011101111110
110111110111111aa01111011111011011110111111101101111100111111000111111111111110100111100011001011111101110011111101011022012110110200201112201002200010110011111
01111100011100aaa10111101111011011110111011101111111011111111101111111111111111111101111011001101010100111011111101111211122110021210112011212011202111110011101
10111010011111a1111111111111001100111111010111101111111101111111111111111011111111111111111111111110110111010100111110022122202100110221122111100112111111111111
11111111011100a0111111110011111111111111011011111111101111101110111111011111110111111100101100011111111111111111111101221211222112222212111101221201111111101101
11111111011110a1110111110110110110111111110101111111011111111110110011111111111111111111110011111011011111111111100011121122201220122211102222121012101011111111
11110011000100a1011111110011110101111111011111010100101111011111111011101110010111001111111001111111111110011111000112200221121020012111221221001120011111110111
11110111111101a1011110111110111111010011101011011011011110111111111111111111111001011111111110111110111111001111111112220121122101111202202211102102110011111111
00111011111111a1011110101101111011111011111111001110011111111111111111111111110111101101111111111011010111101111110100121211120212111120022110110022011111010001
11111111111111a1110101111110101111111111100110101010011110111111111011111011101001111111111111111111011111110000011110211102121121121112121222212202111111011110
1111aaaaaaaaaaa0011111111111110001111011110101111111101111101101111100011111101010111110000111110111101111111111101110211122001212220122210012102210011101011000
1110a11111011111101111101101000111110111101011110101111001111011111101110111111111110111111111111111111100011110101111122121201221222220211102122112110111111011
0111a11111011110111111111111111111111011111000101101101111101111011110110111111101110111111111010111101110011110111111210111102021100101201121221010111011110111
1aaaa01111001111011101111111100110111100111111101110110110001101111111111111111110111111011111101111111111111011110112112021212212202210202022122112101110101110
1a01101111110111101111111111111111110111011110111111010111101111111110111111101101111011010101100011101011100111111111221112210210201221221110122211111111111011
aa11111011111111111101111101111111111111110111101001111110101111111000111111110111111111001100110010011111111110110111211122221211121122212002212121111011101111
aa11101111110011110000111111111111111111111101111111011111111111110010111100111111111011010110111110111111111111111112110102112112022122010221112202111111111111
aa01111111101101111111110011111110101101111111110111101110101101101001111101101111111111111111101110011101001101011112220120210222111122211121112100110101111101
1111111111111111111010111111111010111100001111111110101111111101011111111111111111011000011111111101101111111011101111122121100212112210110212102211011111111111
1001111111110100111111111111111111111101001111010110111110011110111111111101111111110111011100110111110101111111110102121221111122012011011001202010011011101111
0111011011011111101111111001101011110110101010111110110110111101111101011011001011100100001111111011001000101111011010122121202221212021122222211202111110111101
1111111100010101111001110100011111111110011111111111011111011101111111110000111111010101111011111111100011110101111110200122210121211220202102010122111110011100
1111111111111110111011111111111111110011101011110110110111111111111110111011111111111000110110111011111111101111111111221111022212102212002111010110100101011101
1011111111111110111110011101110111111111000111111101001111111101111110111111011111111101111111101111111111111101111110020122210111101220120220211121101111111111
0110011111011111111111111100101111101110111101111011110111111100101110111101111011111111101101111111110111011001111001112210112211112112211120221202100111111100
0111111101111101011111110111011111101110011011101111111111111101011101010011111111111101011101111111011110011011001111002220120102210212102201202102111111011111
1111111110110111000011011110100111101111111001101111111101101111100111111111111111110111101101111111100010111111111002222220010112220011222211011112100001011010
1011211212012011002202101201012001111011110101011111011101110111101111011111101110111111111111110101111011111110111111111101011111111111111111111001111111100111
1112122112220012222100111111011221111010111101011111001110101111111111001110111111000111111110101111011111111011001111011101111111111101111111111010111111111111
1111221111222222011121112121120221111001111111111111011111111111101101001111011101111110011111111111011111101100111011111111001111011111111111110111111100111111
0022010111012202220211110011222221111111111110110110110101100110111111111111111110010111111011111011111111010011111111111011011111101101111111110110111111100111
1112222120212220222211122111100211111110011010111111111110111001101110110010001111011110111101110111111111111111111111111111101110111111101011101111100011111111
0100111121001122100022122201201111111101011111111001111101111110111001011101111111111111110101100010111101001111111101111111111111110011111111110011011111100010
1111222110111101021112112202102111111110111111101111111011111101011011111110111001011110111011011111001111111111010111010111110111001111011111011111011011010111
0112001211120112111001200211112211111111011111111100110111010111111111111011110111111111111111111101111101111110111111111011111110011111111111111111111111110111
0121212112202221122021121221100210111110112002121112021111211202220212111110101111110111110111111111111011110111111001111111111111011011111111011011011111101111
1021011211221111200111221111020220111010112211120021222222202211211222120110111111101111111110111001111101011001111111111010101110100111111111111111111111111011
1012111110010200112212021211011201111111011101011011012211021222211111010011111101011111110111011111111110111101111111110111111100111111110111111110011111011111
1101001211122201120020022101122121110111002021012212111120201211001010210011011111100111110101100111111011011110111111111111111011101001010111111110101011111111
1112102211012222110211120111002111111111012211110111221221210222121112001110111101101011011001111101111101111111111101111111110110110101110111111111101010111011
1121221201212121221120222000020121011111111200202211122121021111212021222001111111011110111110111001111110111011110111111011111101010011111110011011110011111101
1122212110221120102120222101221021011101111102110212212102210001201102201111100111111111011010101011011110110100101111100111010101111111111111101111111111111101
1112021212222011201101111222222001110111111101221101110222212222221212210111111100111111110111111011111111101000111110011111111111110110111111111101111101111111
1101112122222111212001100210222121010111100122102202222002221110200211111111101111110110110110111111101111110111111110010111101111011110000111111111111111110101
aabbbba120100102122000210220121100100111011211202222212222011102101211211111110111111010110111011111101111111101011111011111111110011111111010111001111111011111
111111b121222221121102121012021221100110112201021222102121112220200121222011101111111111011111010100111111101111101010111011111100110111110111101011111111111101
112220b221022001121112011202001221011111002200220020211201111212112122111101111110011111111111101101010111111011100111111101110111111111111110101001111101111111
110202a101211120221002212200102220110111111212212122111221111201201021022111111010111011101000011110011001101111111111101111110101111111111001011110110110110111
101211b200122011221221220210111221101111112102202010001110222222201112101011111101111111111111111111011110111101110111110111101111111111110111011101111110111010
101012bbaab11012211102201122120200011110111122012221221201120212122211012111111101011100101011101101110111111111011111010111101111111111011111111111000101111110
1121211210b02122212221122012101111110111112010100222210021201211202102121011010111111110111111111111110111110111111110111101111111111111111101110011110111011111
0010212212a01102011120111012220210110111112012221122200212202100201120021110011011110111112212120221210122102100222212110101101111111110111101111111110111011001
1111220002b21101210212212110102221011110112021022002110120121000210011212011111111101101121120212112111210011020222010101101101010111111111111111100101111111111
1111002221b12001221100222222012101111111112111111102112022100112021011101111111111111100112112111212122121121202222222221101111011111111001111111111111010100101
1122012122b22112222220022222211211111110011220100221021221121200022202122111111111011111120121112210220102122012020101111110111011110111011111101111001111111001
1122222102b21022210112211210210101101111100211012211110112211112021222222111001111101110100112110200221220222011002222021201001011222111011111011111111111011011
1121202200abaaa0210022210011222220110101112112111111201200122221222222010111011100111110101101002111211221222212211022021101221220212211100111aaaaa1011101101111
11101211122102a2221101110112102121001110112102111122020111211222222122111111111111101110101222212211112222222122212222101022221212020111011110aa11a1101011101111
00101011101101aaa101111111011011111110001012101011022212221111111012210211110101111101111112220111212022220220122222222111201111122212111110111a01a1010111001111
1111111111111111a11011111111111111111111111112012211212121221112101221011011101001101111012121122122222122212200222202120022222211102111101aaaaa01a1001111001011
1111111110001101a11111001111110111111110100201222121221222212200021222122011001111010111121002222002021210120202221222222111022021100201111a111110aaa11101111111
1111111011110111aa1100111110101111110111110111121122122200222121111010111111001111111111111120121120122212002220220020002002010211001011011a10111111aaaaaaaa1011
01111111111111111a1111011101111111111101010120112120100220100112111002120111111110111110112021112211212210012210220220221111222122212210111a111002121221ab2b0022
1111111011111110aa1110111111111111111101112022102021210122220201202211210111011111111110101221112112201202222212120211221002102111221ba1011a110120112101bb2ab110
1111110011111111aaaaaaaa0110101111111110112022211210120022111020201222122110111011111111111011221111221222022212100202021222121211122aaaaaaa1002201021212121b220
1111101111111110aa01111a1011111100111111011202222211111022111111111022122111111011111101121022202022201121000222121021220102121210121b1111aa1120202222112202a110
0100011110111110aa11011aa111111111011001110111110111011011011011010001111111111100011111012210222211111222220220020221120121211212102b0011aa1112211221111011b200
1010011110101100aa111111a111111111100010101111111111111111111110111101111010010001110011122111200212220220121022122222222020021010122a1010aa1110222212202112baaa
1011101010101111aa111111aaa0111111111aaa111011011110111011111110101110111111111111111111101211012121112222222111222112011101001021210b1112022122212212020212222b
11111111100111100101111111aa111110101a1a101011111111101110101110111111110011111111010111111112111012022111221202222222220212122212101aaabba10112011122212121222b
110011111101100110111111111a111011011a1aaa111011001011111111111110101101001111111111101012021011121120112020122022221002012211202122222222aaab22010222220212222a
011011110111011011111111111a110111111a111a110001111111101111111111111111001111101111011111011221112112101011020222220212202221211212201221120babbbbabbbb02221220
101111111111111110110111011a1111aaaaaa011a111110111111111001111111001111111101011111011111222111021002222102222222220122122121122121121011102bb121022bba22212002
111111010011011010011111111aaaaaa11110110a001010111011111110111111111011001111011010111011111220202211221212202122002202110120111221212012121ab022202b0210212222
01111011101110111101111111111111110111111a10110111111101010110010011111110111110111111011221220210212120202022222220001021120222011222110202121122222b2021122222
01111101110111111101111111111110110aaaaa1a11111111110110110000101111111111111111111101110211110110012101022010121220120220020122211010021101100121202b2002222120
11111111111111101110110111111001111a111aaa10111111011111110111110111111111111101110111101111002111200112020222210222010202021222201012200120100022021babbbbbabba
11101111111111111111110011111100101a1111010011111010110111110111111111111111101001111111100121220211201222202220202220221111211011121200002121222012221022120022
11101111111111011111010110100111111a1111100011111111110101111111100011111011100111000111022211122221022212001220222022020122012012122120011012211102212222220212
01111111111101111111111011111111aaaa1000011111110011111111111111111001111001010111111110120120120112011112010020211120221002011100200211121202012222202022220202
10111011110111001111011111111011aaaaa110111111111100110110111101111110101111111111111111012201122011120212122022221202100222000112011010101121110102121011221222
01100010111110111111111011111101aa01a001111101010011101001010110011101011111111101111011010121120121102211020222120222222020120221021212121022202220110121202202
00111111011111111111010100111111aa00a000111111110111101011110011011111101111001111111111111111111111011222220102212012000112020001211020210210222211021220022022
111011111111111100111011111100101110a000111111111111111111111010111111011101111110111111101101111010111201112021111121012212102120012110110121222222222022022212
111111110110101111111111111000111001a111111001010110001011111111111111111111101110111011101111111111111122110121221122211220011121222210222012220012021222222202
111011111011110001111111100011111111aaa1111101111001011101111111111111111111111111111111101100100111100121002112022222211100212101000110200201220200022011200122
10111110111101111011101110011111100111a1aaaaaaa10111111111111111111111111110111111011000111111111111111101111001101011111111111111010221211111112102222211210220
1111011010111111111110101111011111100aa1a10111a10111101101111101111110101111111111010111111011111101111111011011101111111011111111111122110200210011221122222102
1100111101111111101111111110110111011aaaa11101aaaa10111111110101011101110100101110010101111110111001101111101110111110000111110111111001112102222202120220002221
