152,6
6,1
48,45
153,11
97,55
77,8
14,54
22,34
21,61
41,99
111111111001111011011111a111111111101111111111110111111111110112201202211001012002120011aabaa101111aaaa001110110101111111111111111110100012112121121120021212121
111011111111111111001101aa11111111011111111101000011111110111110112212011101122020102221b1012111101110a111101111111110111111111111111110112111122022221122211012
0101011011011110111111100a11101101111101111111101111011110011111112110001112212022220011a0211110111011a111111111011110111111110011011101111221211021001212121221
111111110111111111101aaaaa11111110110011111010111111111111110122110210001112201222202102b2221011001aaaa101101111111111111111111101111110101212120000210122211011
100110101111111100110a111010111111101111111111011011111111111010121221abababab1011212121b2112011011a111111010111111011111110111011111101112012112122210112120210
111111010111111101111a111111011111011111100111111111111101111122021111a011111bbabaa12121b2002110111aaa1111111011111100111111111111110110101111220111112012020222
01111111111011010aa0aa111111110111111111111111111111111111111110020111a12221211121baaaaaa020011111111a1011111111111111110111111111011111101022112222222121220112
11111111111111111aaaa1011011111101011111111101111111100111111122202122a1200122212000212abbab111111111a1111111001111111110111111111101011011222021111021112122111
11101001111111100a1101110111101111111111111111111110110110110110112122b0202101201021121ba2ab110101010a1011010000111111101111110111101011111200021102120111111021
10111111111111011aaaaa110110111011111110101111111011010011011110020212ab1121020222211110bbb101000111aa1011101101101111011111011011011110102020212020100111222112
111001101101110111111a1110111111101011011010111111111011101111112202120abbbb020002120102021111110110a11111111111011101111011111111110110101112220121111021120110
100101101100100011111a11011001110011111111111111111001111101110002020120021abaababbba121222011111111a11011011111011110011011110101111111111121102222122101122021
110111110010110110111a11001111111111011101110110110101101111111222211212112221221020bbbbbaabaaaaaaaaa11111111011111111001111110110101011112102010110110112102002
011111111111010011111a111111110101111111110110100001111011111121120022110122121212111211102110011110101101011111111111111101111111111111011111022021211200221122
111111110101111111111a111110110111101111111111111111101111110020211212221222101210022212201210111110001001011111111101101011010111111110012112010202021102200221
111111101111001111aaaa101111111011111101011011111100001110111001112112012222022211001122200011100011001100011101110111111111111111110111000101220000021121111221
11011111111111101aa101011111110111111111111001011110111111011001121211101101221220112202220120111111110110011111111011111111101111111011111221212221001aa2121111
01111010101101101aaa00111111111101101111011010111111111110111121121212120200221222202221202111101101111111101011100010111101111101111100111221211021212ba1200222
0101aaaa10111110111a01111111011111111101111111001111011111111111211212211011112120012122220121111001111110011011110111100111011100011110110212021210112ab1111021
1111a10a011021aaa0ab10110011211201102201111111111011011101111122012121102111011121021212222121011111111110110111111111101111001110111111112212001212baaab2122011
1011a1ab221100a1a1b101222001001201011110110110111110111111101101121201212200120112201110102000101111111111101011110110101011101111111011112020122121b210abbabbba
100aa0a0222210b1b2b202100101221121222110111110111111111001010110121202222222020212200221210021011001010100111100111111111111101111111111112211012210a2211112122a
111a11abbabbaaa2bab221212222202211122011110111110111111011111101121212220111122120202112101111010111111100111100111110111111111110100001112222210101a02111202021
111a101012112122122202022101222212211011000110111111111111111112022112012020101201110122201210110111011100011111111111111111011111111101112112111222ab0102022222
111a1012212201212102120021102221212202111111111111010110111101110111101110111111111111101011011110101011011111011111101111111100000111010112122211220a2001101021
011a10121110010011101211021201120221120010011111111111111111101011111111110111111011111111110101110110111111110111111110111111101111110000122102221aba2210212102
1aaa01112122221012100211111221212001121110111111011111111100011111101111101110101111011110101111111011111101111111111111111110111101111111111012112a021122111021
1aaa10111011122122100112100122120200221011111101101110111111111111101011111101110111111010011110011111111111111110111110111011101111111111111101111aaaaaaa111111
1aa011012220110112110020120011222110101111011011011111111111011111011011011111011100111110011101110111101111110101110111111100101110110111111111111111111a101101
11a111121221111212011021112022012102021111011101111111011111101111110111011111111011110111110111100110111111111111101111111111111111111001011101000111111a011111
10a101112121002221110122101121011112220112202011122211122122212211111111111101110011011011111111111110011011111110001110111110110110111101110111110110111aaa1111
0aa111000120112111202010111102211100202121111101211112221202111111011111111101111011111100011111111111101010011011101111111101111010101110011111111101011aaa1001
1a1011022102022210101222021112101222021211111022222212200010110211101111111101011111011111111111011010111101111111011111111110110110111111111111111111111a111111
1a1101110002121010111102221022212111220022122221111101100122101101011111101111100111011111111111110001011111101111110011110101111111111110111111001001101a101111
1a1111101011022021000112011100221210120122111111211211111102012011111111101111111111111111111111101111111111011101111111111111111110110101101111111010110aa01001
1a11011012112222201120121222101220222220122012121102011101202011111101111011111101111111111101100111110001000101111100110111111101011010110100111110101110a11101
aa10101210111212100221202021210112102212212102211201120120120212110101111111011000111111111001111111011111111001011111111000011111011011111111111111101111a11111
a1111011220111021212120100211222221120020011111121020211122122120111111111011101101111111110111111011111111111011111111101101011101111111010110111010aa111a11110
a1110012121120202101200022122201120102212202012121211102211022111111011001111111111101011111111111101110111111111111111001111100111111111111111111010aaaaaa11100
b1010011122001212220222121122121201212112020221021122111221221221111101011011011011100000111111011111101111111111110111111101101111111111111111111111a1111011111
12122020202211202112201222222010021210210100221221202211202120211111111111111011112020102110120221210012201221111110101111111111100011111111111111111aa110111111
12022112022222201222202222221222222220202120221222110012121212221101101111011011110222100112112222102100211112121111110111101011111111011110110111101aa101011011
10221221220122122102200122022212122012200221121201110112200000220011111101111110110210220110221121121101210221002011111111010111101101111111111010101a1111111111
12211222210222020222202102010012121222010121102211222202012211011101111010111011011112122210121202200022121111111111111111010111111101011111011011111a1111011111
12202210222202210200222222110201112212211102201121011121222121121011111101011101012021211102222212222101212111021011111011111000111011001111111111110a1010111111
20111022221210122212222202220121222022212222202021222121110121111011011111011110111122121001011202102112102220220011111111011111111111111111111000111aaa01101011
2211102222212110222222222220220120202020122202122010220222202121011111111000110111120121121021101101220212122022211101111111011110111111111111101011111a01101111
1112012202222222222202222122120022202101112212222221110220112220011111111111111111101122101111112112222112212020110111111111011111111111111111101011111a01010111
1102212222222022220220200020220222222212212202222212000011021122111111110101101111122102122220112121020021101021110100111111111111111111111110111111010a11011111
2001210020200220222220020202220022221202122111212122120221122220111101111101100111012201202212112112020221022002111111111101101111111101111111110111010a11111111
0121002122202112222022222222222120211120111101111102212121022222011111111110111101211101210021020021122121121121001111110111111110111011111101011111111a10011110
0121202222222202222212201101222222222212211112222222211211110212111111001111111111211212212212210222211021101102210111111111111110111110111011001111110a101011aa
2020122222022222222221222122221212021220111112221020102210101200101011101100111101122102111011210112022021122000101011111010110101110110111111011001111a011111a1
1220000221021022222221210022221112202010121220221111121210012122001111110111101110100001210212022212102211210211111101101111111101011111011011011111111aaaaaaaa0
1022122112200221122202002212111021210021012001120121222021202101011111111110111011211112112100111220122122102220211110111101111111111110111111101110110aaaa11111
1121112102222122022212022122121220121121022211210110221221111211111111101111111111222221221012222210102212112001001110101111111110111111111111001111011a11a11111
2012001202220102022202122012220022122100102112001202211120011212111110101111111111212000111020011121220011220122211111111110011101110111111111101111110a11a01000
2102212201012222212220120220021212220120121122212112012012222202001011110100111101221122111210211112221200121210001110111011110111111111111111110111111a11a10111
102211222222022221121122221200111222221010211122122122220121021111111110011111101112111222221121121100111110121221011111110111110110111111101111111111aa01a11111
120212221222111010222002220122012012100021211111021011112221221211111011111110111111022002211122222111210112100111011011010101111110011010011011010111aaaaa01100
2012210221020202221200201021220010011111112212002022122220011110110011111111010111222121121002201112202200021121210001110110111011111111111110101111111111101111
2020022211222222102021112211201101112011001111100101011111101111001111111111111011120022210211221220122202121102101111111111101111110110011111011101101111111011
0111222202121012102112022222222221211111111111011110101111111111011111000111010101212201112200011001010221102022101101110011011010111011111011110111111111110111
1211022120122211220120222220220102221101111010111111111111111111111010111101111110102110112121122210120121121012111001111110111011111101111111110101111011110110
2121010212122201112210122222121211111111111001111000011111111111100100110100111011110210200212112011102121202102111101001010110111111101111101101101111011101011
2112122202022222102001221200022112120111111010111111111101011011110110100111000101222112110210121012211211112120111111011111111101111111111101100111001011111101
0202120212220121122010222021021110112110111010011101111111111110111101101001110111202221221122211012212002121122111111111111111101111111111111010010101111101101
2221021211212211002001120222222111111111111011011111011101111011001111111111111111111220212220021221211021100110111111111111111111111011111101110111100111101110
2112222021122220222221110221222122222110111111111110111111110111110110111111011110121212102121121021212121011211110111111100111110110100111011001111011011111101
2221212122020012202122102222221201011011111111110011011011111110110111111110111011102121200022211102112221111211201111010101110011001111111100110111011111111110
1111111020112122112001212011220200110111110111111011110111111111110111111101111101121122112121121212012201120112111111011111100111100100101111010111101111111110
1111110011112101101120121122221202202111111111111011111110111101011111011110111111101111111101110011101111111111101010111111110011111111111011111111001111100111
1111100002102010001211112021022111101111101111011011111111111111111011011111111111111111110011110111101111101111101101111111011110011111110100111101111111101001
1101112011121022112111121111202010211101111111101110111111101101111101101111111111111111111010101111101111110110111111010101101111011111111110100111111011111111
1111111021020122211222122121002211022001111001110110010100111011111111111101110101101110110111101010111110011111111111111110011110101111011110011111111111111111
1011101112112100221222201211211221102011011111111101111101101011111011010110111011111111111101110001111100111011110110110101111000101010110111111111101110111110
1111010221221121021012212122102211202010110111011111101111111101110111111110111111111111101101101111010111111111010111110111111010111111111100011111101111011011
1111111111111101110100111111011111111100111111111101011010110110111011011111111110111011111111111111011100111000110111111111111101100011101101001111101110111111
1010111111111111111100011110111101011100111101110100010010101111011111101101011111111111101111111011111110110111111111111011011111011101111011111101110100111111
1111111111001111100111101001001111111111111111101111111111011110011111011111001111011111111111111111110111111111111111011011111111001111010111110100111111000111
0110110111111111100011111011100110001000111011111011011111011111111111110110111111101111111011111011011111101101111111100111111111110011010001111011110110000110
1111111101011111111110111001111111011101111101110111110111101111111011111011101111111011111011111111110111111010111100011011111111111101111101111110111110111110
1111010111011111101111111111110101110001011001101110111111110001111111010110111111111110111111101101101111111111001011111011111010110111100111111110110011101110
1010001111111111101111101010111111011111011101101001110111011011110101110011011111110111110111111111111011111111110101111111110111110111001011110111101001111101
1010111101111110010111100100111102112100200201112001202121111101111111111101100111010111111011111101111110111110111111111110110111110011111111101111111011100111
1110111001111111111111110100110120110012001122101220022111101110111011010110001111111111011101111111111000110100111111111011111111111111110111110101110011110111
1111110111111111011101001101211122121111012011111000111221111110111110110110011111110010010111111110111111111101110111101101101111101111101111100100111111111111
1011010010111111111011101101212211221100212122022022110001101111111111111001111001110111011111111111111101100101111110111101111110111100111101111111111110111111
1111110101111111001011111121121121211222110011212000221221100111111111111111011111101111111111011111101100101111111110111101010101110011110110011111011111010111
0011010111110101111111111021211201212021212220211111002011101110011100111101111111011111101111011111111111011111111011111111110001101111111111111101111010111110
0111111111110110001011101111011212120210212201120022222101101111100111101110111001111011111111111011111011111111000111111110110110101110101110001110111011111011
1111110101111111111101101102221122222001210012011212122211111111111011111111111010111111111111011101011111111110110110111011110110111111101011110101011111111011
0100011110101111111111101122221202001021112121121010102111101011101101100011110101111101111111111111110101101110110110010111111011011110111111100111111011111111
1111111100111101110111110122111110221121011021121021121100111111111111010110111011011001101110111111111101111100011110011111111111111111111011111110111100110111
1101100111010111111101101121212012122202220212111221002201101111011111011111101111011100111110111110101110111111111111011011111111111011011011111110011000111110
1111011101011111111111101121201201200001211021012122212021110011110111111111111111111101011101011111001111111010111011001111101111110111101111111011101111111111
1111110111111111110111011102111210020221121002121021201201010111110111011110101111111111001101111111111111111011111111011111101111101101010101111111111101101110
1111111110101111111111011012110112210112210122121101121111011111111110111011011111011111111011110110000011aaaa11111111110111011111101111111111111011111111101101
1111111111111101110111101112112102021011011021121001102111111101111111111010110110111111101111101111111101aaaaa1111001011011111101111101000111110111111111001111
11011010011111111110010101122210021111211120222202212120201111111011011111111111111011111111110110010011111aa1aaaaaaaaaa0101111111111111111010111111111111111111
11111111100111011111111110211212011112112010122121220010111111111011100101110111111011111111011111111111010a00111111aaaa1111111100111110101010111111100011110111
1101111111111101111111111110100002110202221122102121111111111101111011110111101110111110111101011111101aaaaa11110011a1101000111101101110111100111111011110010111
10011110110011100111101101121022112101220221221120111211011101001111011110111111101111111110110011011aaa111111010010a0011110110011111111011101010111111111101111
11111111101011110111010111222211122222120111201211122102210111111011111010011111101111111110011011111a11101101110011a1111011011011111001011110111111111111111101
011111110111111011110111101100222212021222112121111110121011111111111110111010111111000110aaaaaaaaaa1a11111110001110aaaaaaaaa01111011011111011111011111111110110
010100101101110011100110012111221021111211111022220121001110011101111011010111111111111111a0aa11111a1a0111011111110111111111a10111111111111011100111111111110111
111111111111100011101111101121021221122211021011211121211111111111011011110011011101111011a1aa11010a1aa111111111111010111111a00011011011111001011010111101111101
1110110101111101010101110110110221220210122022220002201101101111011101111111011111011110aaa1aa01111aaaa011111110011111010110a01011011011111111100000011111111111
1110111011111011111111111102122222222122221021222210210021010111001110111011111010111111aaa011111101111110011111111111111101a11111011011011111101111110101110011
111111111101111111011111111021121121210012121001220201022011011110111111000111100111001110aa11110111111111101001111011111110a10010111111111110011010101011000111
1011111111111001000111010010111221002101011120110200102021101111110111111110110001111101111a01111111011111111011101111110011a01111111111111111101111111111101111
111101111111111111101101111222102122111122021121211011211111101111111010110110011011111011aa11110111001011110111111101111010a11101110111110110101111111101011001
110001011101110101101111000201222211201112111212012211202111101110110110111111001110101101a111011111000111111111111111101011aaa101aaaa11000100010111001111110110
01110110101010101110100010212212201001021122221212222212011101111111001101110010011110111aa10110111101111111101110101111101110aa11a10a11011111111111111000111111
11111111111111110011111111222121211002200210102001221221111111111111111110101111011111111a1101101001011111111001111010111111111a11a11a10001111111111010110101110
111111111101111111011101001101111100011111111101101111111110011111111010111110111111111aaa0101111101011101111101111111111111111aaaa10a01101111110011111110100111
011011111101011110111111111101110110111110110101011111011011111110010110111101011110111a011111110011011010010110111011110110101111011a11101010111110010111110110
11000110101011111101111111111110111111101110111111100110110111111111111101010011011111aa110101111101111111111110111111110011111000001aaa111001111111110011111110
11101111111111001111001010011111101111011110111110111001101111101101011011110110111111a111011111011111111111011111111111111111011110111a101111011111110010111011
11101111111110111111111111111100001111101000111110111101011111111110011111111111001010a111111111111111111111011111111111001100010011101a111111111111111110100111
