156,111
2,118
96,10
55,116
36,35
91,118
2,39
19,78
21,65
106,58
00100101011101110111aaaaaaaaaa0011011101111101011111111111111110101111111111111102122020211110100110120222020120010011011110111111111101101001110110111110111101
10011111111110001011aaaaaa00101111101110110111110111101110111111010111111011110012210212122210101112222212112001110110101111111111110111111111111111010011110111
1101110111111101110111111a11111111111111101011111111111110111111111011111110011111212212121101210210122201111221110101111101011111111111110111111011110111111110
0111111011111111111101aaaa11001011100110111110011111111001100111111111111111011100202120012022221210100212001212011001111010011111011111111011011111101101111011
0111111101101111111100a11111111111111011101110011110111110111111100100011111101110101012011121211002201202121110111011100111111100110101101011111111110011101110
1011110111101011001011a00011111111111001111111111011110101011111111111111111101002011120101121001112212020102121111001111111111111111110111111000011100111101101
1111111110110110101110a11111101011111101111101111111111111111111111001101111111011202102111220222122211112111211111110111111110111111011011110111111101111100101
0101001011101111111111a10101111011101111111111101111111010111111110101011110010012211222101212210212122212102002101110111110101101010101100111111111011001111110
111111111110111111111aa11111101110101111011110001011111110111101111110111111111001211121221210201222110001011121101111111111111101001111111110101101111111101111
11100111111111011111aa111101111111101011101100111101110101110011111111111111111111020022112200221211110222121011111111111111101111101111111111111101111010111111
11111111111111111011a0111111111111111111111111011101100111101101111111001111111110021121101120110111101122101121101111111111100011111011111101010111111101111011
111111101111aaaaa111a1001100111101111111111110111111111111111111111111011011011110221202212122122112122221120022111110111111110111111110010011110110111111111111
101100101111a111a110a1111111111010011111111011010111110011111111111101101101111112202212012212220111210200020112111011111111111110111100110101101111111111111111
100111111101a110aaaaa1111110111111111001011110110110111010011101111111111111111112021212021110011221100222222112111111111001111111111111111111110111111110101101
0100111011aaa111011111111101101111111111011111111101111111011011110110111011110110221002001211012211211022122222111110010011111111011111101110111111111111111110
1111111100a10011111111111110111110111110100110111011011111011110110110111111111101212121121102222222121021112222101111110011110111100010111110011111001111111111
1111111111a10111101111111001001110111111101110111111011111111111111111101101111101110021102012220122211012002202110100011101101111111111011111111111001111101101
1011110111a11001111101111111111011011111011011111011111111110011111110111111111012111211022211122012221121212101111010111110101111001001110111011111110111111011
1111110011aa10111111111110010011110111111001111100011011101111010110110111110011101012111211012122221211212002011101100101110110111101101111101001111000110aaa11
11110101111a11111111111111110111110101011111111111110101111111110101111111010111122221111111011221102022221222020011001111011111100011111111101011110110111a1a11
11110111111a10111011122112220121201010220001111101100111011011011101111111111101011111111222222201202122220102221111110111111111100101111011111110110110110a1a10
01001011101a11110111021011111122121102110120221020221111101111011111001111010101020222221220211121121011122202211101111111111111111110111111111111aaaaaaa1aa1a01
10011010100a11101101111120121110111111211221220112220111111001010100111111101101111021220212021210222220122111221011111111111111111011111001001aaaa01111aaa11aa1
11aaaaaa111a11111000012212002121111202112221122222201111111100101111111111111111110112110022112121120011010020221110111011011001110011111010111a10101110100100a1
01b0022b01aa22221111001220201212001212210110211110111110111110111111111111111111122221001022122202020111111212100110010111111011111110101111011a0010110111111aa0
22a1202babbb01002211121002021112200111212212100211111111101111111001110111110000120212121121210021222111110200111111110011111101001111100011111aaa11101111111a10
2ba02abbab2a2212010111112111111120212002221010111202101111111111111101110111111100110111111110101111000110111101111011111111101110111101111111101a11101111101a10
bb022b01020b2202211112201220111210012201021102211211110110111101110111111011101111011011010111111111101111111110110011011111101110111101111111110a00110110111aa1
2111ab12122a1001021111021212111220201211211101212222101010011110111111101111110110100101111100001111101111111111010101111011111101110111111111100a11111101aaaaa1
2212b12ababa120201011201201100111112112201222122121111110011111111111111100111111111111011010110101101011111101111111011111110101011101100111aaaaa11111001aaaaaa
1112b10ba1aa022211111221110201222210120101012202112210111111101111111110011101111111111111011001101011111111011111111110111111011111011011110a0aa111101100111111
0102aabba211221212111121200202122200120122122010222010101111111111111110101111111111011010101011111101111010111110110111111111111110111111011a1aaaa1010010111101
222222212101020220001212012101001010112012121122012211110111101110111011001111101011111111111111111111011111101111111001100111011111111010111aaa01a1101110011111
11102202221222112211111202212212211000021111122221101111111111001111110011111111111111000111111110110011111111100111011111100111111010101111111001a1111111111101
20101202221210100111022122122112112122222122202020111001111101101111100100111111111111111111111111101100101110101101101111111111111111001111111111a1110110111111
11211202120110001111122122011220101211112211001111111111110011110111101011111101111111100110011111110110111111010111110111011111111110011111111111aaaaa101010100
110221211201011111111121201221120111102002202112122211001101101111110111111011111111110011111111101111111110011111011011111111001111111111111001011110a111111111
101222210121221120001101021221010021011122022122222111111011111111111011111011001111011110111101111111011011111011000111110111111000010100100110111111a111101011
0111210112001221211010221202010122120021212201202222111111010111001111111111110111111001111010010111111011111111100111111101111111111111110101111000aaa111111aaa
0102211121102102121010222210202212121021100121210212111101100011011011111011111111110111111011111111011111110111011100110110111111101111111111010011a11110111a0a
1211020101112011110111012010121202220212211020102221111101101111111010111001101011010111101110110101101111111111101111111111101101011111111111110011aaaaaaaaaaaa
102112221222211112110011121202100122201201211111020211010100111101111011111111011111101111111111111110111111111110101111110111111111111111110011111111011111aaa1
0111222121012202121112121122201022221222222120222101001111111111111001111111111101111111111111110010101111011101111110111011011101111011111110111101110110101111
0112010122111212221112222002111211001221011120121211111001011111111101111111111011111101111221111121221200202011200100002111111101100010011111111101111001110101
1102110121012220201112210101222021001112012212122022110110111111111010101011111111111111110101201121020122110221221121011011110111111100110111011101111011101111
2111221221120011011012121121201122011220212211111122111001111110101111111110111110111110110121011112212222011202101001011211111011110011111100010110111111111011
2221221102102211111010122112011000111202212222111112111010110100111011111111111111011111101011212022221000101022212120021211111111100111111111101111011111101111
1012011201212221121111202221111112112012111021110000101110111101111111111111111110011010111210222221221100201002020101221110110011001111110111101110011111111110
2202202020021200111110212210220211021120121211211221111110101111111011101111111110111101111020211122200111110111210221112211111111111101111111111100111110111111
1121211020111221000112212122021011122120200121210012110111011110101111111100111111111111100202212121102102122001122220212210110111011010111111101111110111011101
2110122012000222020212002020020122102222101112120210011101101111111101111111101111011101111221210222201212101122121112111111011101111111110111111111011100111001
0111102022222002022222021111011221211110101011111111100111011011011011101011111111111111111200112012021210212110200111101111111111111001111111111110111111111111
0211012212021222110121011202202120121111100011101111011110001111101111111010111111111111100011112112222221121212202110111111011111110111111111011110110101111101
1121212022121122221121211211220012221111110101111111111111110111011111100110111001101011111020122112022222001100122220111111011101110111110111111101111111001101
2222122000222222212110121121100102222010111111111111110111111111110111111101011101111110111010222021200002211111120120222110111111111011101011101010101100111111
1101111211221211122202220022211112201111111010011110101111111101111111111111111111011011111212111022001121211122111022121010111011111110110111111111111111111011
1111111221212010102122111112110122002101011111111111111111111001110111011011010011111110111221121111121212010121012112122011111011110111101011111111111101111111
0111110021000110220121012102201121211011111101011011111111111010111110011101111111111011111102200122111011221121122101100211101101111111011011111111111111001111
1110110122101111011122022002112200010111111011111111111111111110111111111110111111110111111122012100120021012121222112221101011101110101111101101011011110110111
1111112120102221211102122211022001210111111111111110001011101101111011101011111010010110111121111222212011211220120221221111111101111110110101111110111011011111
1111112122211012222111210210120221121111111101111101111111111010110001111111101101011111111101221001201201211100121111122201010110101111010011111111110011111110
0111112110102210120022211020122200101110101101111011011011101111100110111011111111111110111220122001111002022002111211210211111011011101111111111111110111111011
0011012202210012221112212201110212100011111011111110111101110111101001111011111011011011111021221022021111211121202210222111011111011111111011111111010010110111
1111112202202212220122121222211121211101101111111111111110111111111111011110110110011001100121220210220121211120221012002211001111111111100111111101111110011110
1111001212222112220222220212220222222110011011111110111101111111011101111101011111111110111122212100221111122021211101211111111111111111101001111111011001111111
1110212022212102022222021222222221220111001111011101101111111111110111011111110110001011111211202110111122200112102100122211101111111111011111111111111111111111
1111220112111221210102122201222001212111111101101111100011110111011111110111001111101110001212111122201111202121222110211211011001001110110111111110110001111111
1111100221212022122202022222222112020111111111111111101111100111110111111111111111011111111211001022111112022112110102212211011111011111101110110011111111101111
1100202211200222201211212002222222001111111101101111111110111111111111111110011101111011101222221120201010211200200011220011010111011111101011011111111101101001
1111102102020022121212220202212222221111111110101111001100101111001111100111111101101111111211101221210102121121122020200211011001111110110111111111111101111101
1101212012222220221212200202221212211111111111110111111111111011111111111110110100111101111222122120221021222122121100212211110111111101011011111110111111111101
0101100101220222220012220222222222021111111001011100101101101101111101101111111010111001111121202101112120121201221022222201110111110111111001111101100111111100
1101102222221002122221221102122011021111011111101110011101111111111111111011111111111011100012100210211122020221222112022201011011100011011111110111111111111111
1111222202210020222012010221110212210111101101010101001100100111111111011111011111111101100102211220202102122112222200212211111110101111011111111011111111111111
1111120221212212202222122202022221201011111111011111111110011111101110111110101011011111101101110110011011111011111011111111101111110111111101010111011111111111
1110102220222222012100121202212222221110110111110101001001011111010111111111111010011111111111111111011010101101110111100111111110111011101111111110111011011111
1111012000012122222222222220220122220110001110111110111111111110011111111011111100010011101111111111011111111010101110111001101100110111110101111111101111100110
1101121222011012220220102020222100220011101110110110111111111111110111101111011001111111011011011001111001111111010111111111101100101101111010111111011111111110
1110212220200120101212212022111211010111111111111111111111100111110000111111000110011111101011101111101111101110101100110111111101001111111111111111111101111111
1111102210001201222022202222202022212110111111111011001111111010010111110001101111110111111111010101111101111111111111111110100111111111111111111101111111111111
1111202111022012012202222201202220220101111110011111101111111111011101011111011111111011011011110111011110111111111110101111111010011111111001111111111111111111
1110112000112202122121012110022220110101010110101011101111111111101111111111111010111101111011100111111001100111110001111111101101100110111011111101011100111011
1111212012112111202221011222222221211110111111111100111111100110111011111111111111111111111111100111111010111111111111101100011111111110111111111101010111111011
1111212111122202111220022112211200001111111111111110111111101111011101101101111110011110111111110111101111011011011111001101011111110011111111111111111011111011
1111211222021121122112111100210110111101011100111011101111110011110111011110111011100111011110111111101101111101011111111110110010100101111001110111110110111101
0110211121012201212122121122120120201101111111100011111111011111111110011110011111111101110100111011001111111101111101111111011111110101110011011101aaaa11011111
1111100222022021221102002220001112210111101110111011111111101111011110011111011111111111101011101111101111011111111010111111110011111111111010111111a11aaa111011
aaaa210102112022022222221212202210211011101111011111111101111011011111111111111110111101001111111111111111101111110111110111011111101111101111111111a0111a100111
a11a211022120010022022221101212221211011001111101011110111110111111011111111011001111110001011111111101101111111111110110111110111101101111111111111a10aaa101101
a11a211212211112220221221122212122100011111111111110111111111011111111111111011111111110111111101110111110001111111111010111011111110111111111011111a10a1111011a
011aaba212210211211bab121201021001211001110101111111101111111111100111111111111111111111110010111111111111111011011111010111110111111011111111111110a11a11aaaaaa
111122a011221122122a1b22111212212211111110110001001110111101011111011111111110110111110101001111111111101111111111111110111101111111110111101111111aa11aaaa01111
110011b201222010101b1b02121210000211101111111111111011111111111101111111111111111101111101111110110011111011111111011011010111100011111110110100111a111110111111
011121b21212111002aa1a20211111202021110011111111110111101111001101010111101011101111111111101111010110111111111111101111101101100110011101011110100aaaaaaaa11111
a11001a01110010111a10a111111110100111111101111011011111110011111001101111111111001111101111111110010000111111111110111110110111101111111111111111110111111a01110
a10111aaaaaaaaaaaaa11a1111110111111111111111111111101111011111101010101101111010011111111111001101110111111111011011111101111111010010010010100111111aaaaaa00111
a11111111111111111111aaaa1010111110100111111111111111111111111110110111110101111110110111011111010011011100101111111110100111111111111110110101111101a1010011011
a01011aa1111111001101001a0110111111101001110111011111111111111111111101011111010101111011100110111111011100111111111101110111011111011011111111011111a1111100011
a10111aa01111111011101aaa1011101111100111111110111111110110111111101011110111111111110111111101101111011111110111111011000111111111111111111111aaaaaaa0101110111
a11111aaa1111001111110a0011101111111011111100110111010111111011111111011010111111000110001110011011111111111111011111111111111111111111111101aaa1001111100101110
a11111a1a1101111111001a1111111101011111111100111110101101011111111001111111111101111111001111111110111010011111111011111110101111101111111111a110101111101111111
aaaaaaa0a1111011110101aaa01110101100110101001221112010210221021212202121111111101010001011011110001111010110111010011111111011110110111110110a111111110111111110
01011110aaaa1010101aaaaaa01100111111100122222001110121221021021022110010111110111111011110110011011011011001011111011010001111010111111101111a010011111101011010
01111111001a11aaaaaa1010001011111100111012211221002010122102121221212111001111222122201211212102021212101221111111110111111011110111011111000a110111111010111110
01111011011aaaa11111110101111111111111110021121100002002101102020011110110111201212022212121210221102022121110111011111111111011111011111110aa101111110111110111
11111111101111111111111111111110111111002112212000010112120220210110121111112212000222200221021101221000211011111110111011111111011111111101a1111011110011110111
11111101111111111111011101011101111101002220112110221220202202211011112111112221210121212222010201222012012111110101111011111100111111111111a1111011101111111111
11101101111111010111110011111000111111111110122002211111110112112110011111101100001210112122210112200011121101001011111111101111110111101111aa111111111101111100
111111010011011111111111011101101111111121201111210112221202211111112210111112012121221111112220221021221111111111011111111101001110111111111a1110aaaa0110111111
011011101011111001111111111111101111011110012222010122121120111020111021101121001122201211111001112120022110011100110111001011111101111110011a0111a01a1111111110
111111101011011011111111011001011111111121101122102211021202121210111210111102112221020112220102012000100001111011111101111111111101111111110a1100a11a0011111111
111011111111110000111011111110001101010111220012122011211221211112112200101121022122120101112102010210221121111011111111010110101111110011011a1111a10a1011110110
100111101111011110111101010111111011111100200101200221212120111221221121110101221021122001102222221221112220111111001100111111000011111111111a1101a01a1100111011
111110111101101100110110011111011110111101002221101210100110012022022021111100011120101121012021112220221101110001111111110111111101100101111aaaaaa10a1101110111
11111001111111101100101011111101101111111102121202221220122012101202210001112111210101012121121221200202001100101111110111011111101111111111111101111a1111100100
11111110111110110011111001101111111111012121121011012002111201001201211111112212110221211220200110021121210111111000111111110111111111110111110100111a1111111110
11011000110101001011111111111011011111012110021220001221101221121221202101111111211212222022201120222212111101101011111111110110100110000110110111111a1101111111
11110111001110111110111101111101111101112221122000211120002212111122112100111222122121212001212111121221212010111111111111101111111111110101010100111a1111011111
10110111101100111111101110111111101111111022110202121122201012222211120110111221212102201202100220121211210110111101111111101110101111110111111111011a1111101111
1111111101101101110111111111111011110011110011111211110011021001212020001111210121122012212202210222102200211111110111100111101111111001111111111111aa1101111011
