142,9
152,104
130,86
125,86
16,54
140,105
90,83
84,33
107,80
46,95
110111111111111111111010011011111111111101111010a11111111110110101111111011111101111aa11011110011111111011111110011111111101110011111110111111011011111111110111
10111111011111111110111101111111111111011111aaa1a111010000111111111111110110001111111aa1011111110011101011110111111111111111111111110110110111101111111111111111
10011011111111111111101111011101101111111011a1aaa1110111101111111111011011010011111101a1011111100111111111111111010101111101110101011110111111011111111110110111
01111111101110011111111111011111111110110111a01111111110111001011111111111111111111010a0111111011111111101100011101110111111111111111111101111111010011111111101
110111111001111111111110111011110101111111aaa10111011011111111111111111111111101111111a1111101101101110011111111111110110111111001111111111111110111011111101111
011011011110111111111111011111111111001111a1111100111110110101101110101111011101101110a1000000110111110111110111011111111111111110011110111101111111111111111010
111011011011111111011111011111110110111011a0100111111111111110111011110110111111111111a0011111110111111110001110011111110110111111111111111001111101111111111111
100111111011011110010111111111100111011111a1100111110101110010110111111010111111111111a0111011111111011101010111111111111001110111101111101011011101111100111110
110010110110111110010101111111110101111100aaaa1111111110011101111001110001011010111000a1111111111110110111111101111101110110111100110111111111111111111011110111
001111011001111111001110110111101111111111111a1111101111110111111111111111011110111011aaa10111111111110101100111100111111111111111110111011111011110111111111101
111111111011110111101011111111010010110011111a110100100111111111111110111011111011aaaaaaa11111111100011111111111111111111111110110111111111101011111011111110111
111111010111111110111101111111111111101111111aaa1111111101101101111110111110011111a11011011011111110111101111111111111111111111111001011111111111011111011111110
10111111110101011010111110111011101011100111111a111011110111001111111100110110aaaaa01101011111111010111111011110111111111100111111111111110100111110111100110011
11101111110100000111011101111110101101111011001aa101001111001110110111100aaaaaa111011101100111111111111111110111110111111100111101110110111111111101001111111111
111101111111011101110110110111101011111111111111a010aaaaaaaaaa11010111101a01110111111101110111000111111111111110111111111111001110001111101111111110111011111110
111111101111110011110011011001110101111101110101aaaaa10000111a11110110100aa0111110110110111111101111111111111111111011110011000110101100011101111011111111011011
1111111011111110111111110110101101111111111111110101111111111a11aaaaaa1111a1110111011111101111110111111110101100111111110111111111101111110101100111111111111011
1110111111111111100100110110011111101111111111111111100101111a11a1111a1101a1110111110111101111111111110111011110111111111111101010011110111100111101010101011011
1110111111010011111111111111111111111011110111111001011010011a00a1111a2121b2210220121212122112112112011111001001100111100011101111111111111111011111111111111110
1100111111111111111111111111111011111101111101000111101111011aaaa1110b2112b2210102012202100212012111011101110111101011110101111111111110011111111101111111001010
110111111111101011111111101011111110110111111111011111011101101111111a012aa2200211112120211222212122100111011111011111110111011101100101111111111100011111110111
101111011100111101011111111110111011110110110110111111111101110111101a220b00022102010212220100121110110101111111111011111011001110100111111111111011110100101101
111011000111111110010111001011101111111111111011101111110111111111111aabbb11100001220020112220121121111101111101111011101101111110110110111111111111111110111010
001001011111101110111111101011101011011101111111010111011111111011101101bb11102222211122212102112012111001111111011111111111011111011110111111011111111110111111
1110111111111011110110011111100111111111000111101110110111110111111112112111111220111221211011012012111101101100111111101101111011101111111101111111001111111101
1101111101101101101011111011011110110111111110110101111111001111111111121022100121011002122122112202011111110110101111111110111111101111111111011111101011111101
1111111011111011011111110110101111101101111111111111111111011111011111220111112001112100122022002222111111011111011011111111111011011101101110111110011111111111
a100101111111111101010111111111011110111110111011111011111101111111111022201201012122110121222221002101111111011011110111101011111111111111111111111100101110110
a100110010011111111101111001111100111011101111011111111101111110111101021211211110021100221012111220111111111110111111111010111001111011100111111111101111111011
a111101011111111110110111110110111010111111011100110111111111111111110000222100221021110111202201222101011111011111111111011011110101100101011110111111111010010
a111110111111111100111101111111111101111111111111111110110101011101112121001212122010012110120110212111011101111011111111111111101111111111111101011111110111111
a111011110011001110111110110111011110111011111111101111101111111111002220212110100111212202211120121111111111110111100001111111111011111111110111110111101111111
a011101011111101110111111101010101101111111101101111011111101110011112222122121012212210221001011101011101111110011111011011001111011011111011011111110101111001
a111110111111101011010011111111111111011111110011011111111011101011111212022210200110220110202200112111100111001011111111111100111111010111011000111101111110011
a100110010111110001101101111011111111111101111111111000010111011110011122101221101012010212221210111110111111101001101111111111111010111111101110111110111101111
a111111010111111111111111111111110111111111100111111111101101111111111111221202211110212211112000112001111111101101011011111011111111101110111100111110111110111
aaaaaaa100111111110111111110111110111111111011111101111111111111011112121121122221222121122212012021111111101011111110011101111011110111111110111111101011111111
11111aa111101110001101101111011111111101101111110101110011011111111110111212100120101222111111122221111111111011001010111111000111001011111110011011110010101110
11001a1110101001110111110101111111111111111101101011111101101110011111221111201022102002020222112110011111011111111111110110111111111000110101011010111101111111
12112a2111021211022211222122110211111011110101110111111001110110111000020221212202012111120020112022010110011111111111100001100111101110111111111111111111101111
12002b1022222210020121112011010211110011111111111101111111101111110102222100112101002222111102111212000101111010111011011111011110111111101101001011101110111101
12111aabbba11111110202221100021111101110111101100111111111110101111110102202111112102011020111212201001111011010111101111111111111011111111101011011111010111101
1112112101b22011210110022022112111010111001111111111111111100011111110100222022120212111011110021211100111111111101111111111011101111111110111111110011101111100
100100011aa22121002120121001221111111111111011101111101011100011111111020012212021112221220122111212111100111110010101011111111011110111111011111010011010111111
111112111a111021011122220111220101110111111011010101111011101110111101102222211010121221011021202220111001110011010111011110111101111100111111011011111111110011
111212121a212021202021001100111211111111011110111111111111111111101112122122112211122112120011022222111011111111111111011111110111111011111111111011011011011111
101102221b122120211122201101010011111011101100111111111110111111111102222011000012212212221102222221100110011101101111101011111111010010111110110111101111001111
022201001b112220122211111200022110111101110110110111110110110011111112020012212011011110221221120112101110011110111111011001111011101111111111101111101111111110
122122020b001121121211100120012100111101111111011001110110110111110111101222020211100220011201221122101110111111101111111111111100101111111111111111110111111111
121221102bb12101222102020221001101111110011110111111110011111111111110111111110110111110111101100110011111101111101101101110111101111111111011111111001010110111
100200abbba12011212110110112212111011110111011111101111111111111111111111111001100100111011110110111110111011110111111111110111111111111011111100111111011111110
102210b2aaa02102112022022220221011101111111111111101101111111111110011011111111111111101111101101110111110111111111101101011111111110100110111111110011011101011
101111baa2b11012222222101221120111001011011011011110011110111001111010111101110111111110011111111111101110101101001111111101111111101101011110101111111111111111
0221211010b20211210012111210012211011111101110101111111111111111011111101011110101111101101110101111101010111001111101111111111111110111110111111011110111110110
0211121101a20022112020200020020211111111101011110010011111011011110110011111100010111101110111111110110011100011111110101110101011011101011111111111111111111111
1212122211bb2202211111121221002111011110111101011101111111101111111110111111010111110110110110011111111011011111111100111111110011111011111011111111111001100101
12210112122a1200002200112222211111111110110011110001101110110110011011110111011111010100110101011111110111111100011101110101110110110110101101111111011111101111
10101200111abbaa111021021100121111111011111101111110011111111100010111101111110110101101111111111011111011111011111011111101111110111111110101001010011111111111
1202020221210bab222220221122022111111111111001011101111111111111001110010111111110110110011111111111111111111111111111110010111101111110011111110111111111111111
1122010222220a0110011201121121201111111110111111111111111101100111111110111101001110001010011011110010111111101100100001110110111111101111110101110111110111111a
1102021122210b2022001220212002021011110101011110111011110111111111111101100110111010111111111111001111111111111000011111111001101100010111010110011111010110111a
0222120212212abb2020212120111110110101101101111011111111111101011111111110111101001111111111010101100111111111111101111011101100111011011001111101110000100101aa
121210011212211b20111111112222111011011111110100011001111111011111101110010110011110000110111110101111100110111010111110111010111111111011111111111111111aa110a1
120122012120110b00222122222201211111111111111110111001111111111111110101100101110110111111110111100011011111111011111111101111001111001111111111011111aaaaa1aaa1
110212011011111a11111221011121111011010011101111111110011101111111101101111111101100101111011011011011010111111111111110111111111100111111011110111110aaa0a1aaa1
111220221022211b01020212021102221111101100111111111101010111111111101111011111101100111101111110221221022020211220102211101101111111111001111111101aaaaaa1a111a1
122110020111121a11122210212201211110111011110111111111110011111111011110111011011111111101101222012112211112112211211212022101111110111111111011111aaa0aa1a111a1
111021221011100b1222021111221221011010111001111001100111111111111111111111101011111111111101102222210201222112110220122121111001101111111111111111111a0101a111a1
102112010122112b2202200122111102111111011111101101111111111111111000011111021211101222021221000202202000022211120022212222210111111011110011111111011a1101aaaaa1
1211022112221bbb0111012122011212110111011111111111111111101111111111111111011012102221222201222022220022122010211202112000201111111111111010111011100a10aaaaa101
1111111010111a101001101111011111111111101111111111111110111101110111101111122212112021201120222111211200220002220212211022011110111111111101111101110aaaa111a011
0111101111101a011111111111101011011011111111111111111010011010111111000111022202200121122010122212221110222220002112220022021202222022222020112101101aa1aaaaa111
1111100101010a110111010111111100111011011111011110111011111111111111111111022201122002210211022022200222011220222201202222210122222000122020121221101aa1a0010110
1100111111111a110111101111111111011101111111111111111111110111101110011111111212110122102121122202200222112222022121222222211200022122202202221101111aa1a1101111
aa11110111aaaa1010111011011110111111011011111101001101111111110111111010111212210122211112222222220111200221220221222212022122121122210222212011101aaaa1a1110111
1a11111111a1100001111011111111011111110101111110110110101010011111011110111222101122010212111212202022012211011122112220221222122222020022112211211a11a0aaaa0101
1aaaaaaaaaa1111111111111111111110101111101111010101111011111100101000101111112202101111111120022202212000000112202211000222210221120122121222222111a11a1111a1111
1aa111101aa1111011111101111111111001101111111111101111011111111110111101111221200121012010222000020222212211212022222222220002222222122122102211001aaaa0101a1111
1aa110110aa011110011011111111111101111111111111111111011101110011111111111020112222102122210202021222221221122221122212222122021222002200222020112110111110a1111
111110010aa101111111111111111111101101011111111111111110111111111100111111111111210021100000002021020202220011222222220200220210222201022201022101111100111aaa11
1011111111111111110011101011111112210121211211201012212210211100110011101112120222211010102122222121222221212022222222222022212120222022222220111201001111111a11
1111111111111111111101111111111020121210122011101112211002222010010111111100022120211202121112022021222210211112200222222102222122222222222222101011011111111a11
0101000111001111110111111111001021122022022212221121211202211111110111111112022122211211221111221121221221110221221222221222202222112221100122112011111011110a01
1111011000111111111111111101111011121110122212212122222222121111110111100112111121202201220012002012112202121212221122022210220022120022222121111110111110111aa1
11111111101111110011111010011112012022122021121100201202220112111001101111100121121120111001222012221102212011222222212222122110212220012201002101111111111111a0
01011110110011111111101111101000120212211222111022112221212201101011111011122120222101201012221121100012212121210020222021221121212210222212120222101110111111aa
0111011111001101011110110011111011112121122222020122101122111200111110111112222122112222111102212022021202122122020222221201121222222122102211022201110111111110
1111110111100100101101111101111121111012210011121112122120022111111101001012211112222110210121220222221220211021122002022221221222121022202020101211111001101111
1111010000111110111111111111111010112200111222100210011020222211110001111112011112110011021221222222200020211201002211221221220200102222120011222201111111010111
1110111111011001010100111111101101220210110002012111201010101011101111011112220222012201220101000020200221001002222212020222122002102021200221201101111111111110
1111111111101111011011110111111212110210211111021212102010121211111101111111011110121200112102120202222220210101221001222022222222222202022222022202110221111111
1111110101111110011101011110111121221212021211202221222211101011111111101012122111101022100202222212221222022120220222222022222222222202221222022211121200221111
0100111101011111011011111111111110020201211012110212001110121211011111111111221121200122222012022121102201022022222120212222121221002222220002122201101021210111
11001111101111110010000101110111222212102110121002120021120112110111010111abbab112200211120102002111221202020200122220212222202022202010222220222222221211111011
11110111101110111010111111111111022102012122221120222102020121110111111111a002bab1102211112221202211202222211220122201222222202022222020002022222011200121011011
00110110101111110111011011101111100001112020112122122222211010011011010111a11021a1221121122102022220012200122021020222220200221002022222220222220210111202121111
10111111101100001111101100111110012021222112121201212010220201111111011110a12122a0122010221021221110200222110100021220220002222222122202222221122212111212111101
11111011011111111111111011110110221212221122111021010210211121110111100110a00120a2021122210022122111221012111012221202012212122222120222222112020210120110211110
00111111101011111011111011111112211121021000221220110210111111111111111101a01011b2222220210222102012220022111100021022212202122200220222120222012101222012111111
01100101010111010111111011011110111222101212211221212120111112011010111011a11101aaaaaaaaaaaa11111111010111110120012020202222222002212201002020112011222210210111
111111111111111110101111111111012220122120210102010102102111111111111110aaa1011011111011011a10100111101110110100202221011220221222020020222220101010112111110111
111111111111111001111111000101102101111210011220212122001101001111101111aa11101111011101101a11011011111111101012211012121022102222222221222022220222210012021111
1011111111101111011010110001111111112100020210212010212202020010110101110a11111111111010111a11111111111111101101010110111111121210210122211111100212221221011101
1111110111011111111111111110101211221002100211221001111201020011110110110aaaaaa011110111110a11110101101111111111111010111110121201201211221022222122102100200111
1101110111111111110011110111111010222221222220121221212121112011101101111aaaaaa111110111111a10111111110110011101111110110111122211021212210011112112122012121111
1111101111101111111110101111111222022121121201202122010022211211111111111aaa111111110111101a10101111111111111111011001110111111100001112121220210122102012201111
011111111110101111111011111011110112112020212100021011212101020111111111101a101111001110001a11111110101011111111110111111111121210200222101212111111121210000111
111111011111111011110111110001021121021101112221211110221210210111111110111aaa1111110111111aa1110010011110111111111011111111120122122221021111122001122122210111
11111101111110101111110110111112220010221211001120020212011111010111111000101a01111111011101a1111111111110111111110111111101111122222121201022000012221201221111
10110111110011011111110111101112011212021222122111220010112122101111111111111a11111011111111a1111111011000110111101111000111121120222012111210011120210111111111
11101101111111001011010011110111202111222222020212122222100221111110110010110a11111011111011a1101011110111111101101101111111122120202111111222200111221212201111
11100111110110111111111111101111111110111011111111111111101110011111100111001a111111111111aaa1111001011111100111111111111111101112221201010100221212221200021111
1111111111011011110100111111111011101101011011111100110111011010111100111011aa110111111110a101111110101111111111111101111101121121220221212200021221220112121111
1111101111111111110111110111111011111011111111111111111111111111111111011101a1101010111111a100111101101111111101011011110111102221112222221201122200201112221010
1101011011110111110011101111010111111011110111001111111101111110111110011101aaaa1111111111a111101111110111011011111111110111111121021020212202021211112000100110
1100111110101111011111111111111111111011100010111111101110101111110110111111111a1111011111a111111111111110010011010111111101102201022001221101221111000110011111
011111101010111011111111111111110011011111011111111111111110100111010111110111aa1101111aaaa011110111111101111100111101101001122212112221011210202012200220121011
111011111111101100111111111111111111111110111111111111111001111111101111011110a01100111a111110000111111100011110011110111110112122001212202202110211121022111111
001110100000111101110110111011111111110011011111111111111011110001101111011111aaaaaaaaaa101111100111111111111111111011111111121120211211122112112101212221211110
11101111111101110111101011110011111100011100111111101100110111000101100101011aaaa1101111110111011110111111111101111110101111120210012001220022221212002112020110
