18,114
11,16
157,115
112,34
40,31
14,9
141,25
10,42
19,84
10,89
1221011200112100112111121211121011100001111111111111100011111111101011010111111111111111111110a1111111111101111100101110101aa10111100011111111111111011111101111
0111222211212210222002210012211001010111010111111110001101111001111111110110111110111101111111a1111111011101011101101011011a111110011111111110111111111111011111
112021121121221221122022222202110011111101011111111111101111101011111111111111111101011aaaaaaaa111010110111111111101010001aa101111111111111111111101111111111111
120221002222221010111221101121110111110111101110111111111111111110111110111111111011111a11aa1101111111001111111110aaa11011a11111111111111101111110aa101010100110
212222021011212011211212121012111111101101110111010001111110011110101111111110111101111a11011101011101111111110101a1aaaaaaa0111111111110111011011aaaaa1110111111
122011021112202201221110022211100111111111111111110111101101110001101011101111111011011a11101111110010111111111111a1011aa111101111011110011101111a111aaa10111101
120010012212212001122111001221111111111001110111011111111111010110011111011111110111001aaa111111111111111111101111a011111111111110101110110011111aaa011a101aaa11
22112110102012202100021112112111111111110110110111101111111111110101111111111110101110111a11110101111aaaaaaaaaaaaaa1101010001111010111111111111aaaaa110aa11a1aaa
2121112122121111221122122210211111100001110111101110111101110111011111111001011001110111aa11001111111aaaaaa111111110111001111000111010111110111a11111100aaaa1111
1021222221122212202102102211010111101011111011101010101011111111011111111111110111111100a10111010111111111a011110110111111111111111111111111111a11111110aa111010
121212221221212121222011122012110101011101101111000101101111111111110111100111001011111aa10101101111110111a110111111011110101100021222202202222b0220baba02111111
221120210122112110120222211010101110011011111011110011111011011111101011111111111111111aa01101110111011001a011111111111111110100110211112100001bbbbaa22a12212111
0011000112012211211211121101121111111111111101110010110111101100111011111111111111111101aaa0010011100111aaa10111110101111101112212211210012022121212020b12201111
212222221212110221211211020222111110101011111111011111100010110110111000111110011110111111aaa11111101100a1011111111111011011112211012011102121022121211a12020110
12121111111211210112020201210211111110101101111101111011111111101111110101110111011001110101a01111111111a0111111101111111111112112012101011010112111221b21120011
11211221211000122211210011010211111111011111001011101010101111111101101111111111101111111101a11101001101a1111111111111110111111200201210222121200101021b00022011
20101121120210112012022021020210212112100010122020211112101101111111111111011110101111111101a01111110111a1101111111111100110101122222112212121111201112a12010111
11222110221001212121021211102212210222020200022121210022111111011001010001011101111111111111a11011101110a1111011101110111111112111112111121122122222201a21020111
20112211002202020112021120022201220112122111122122010110101111111111011010111111111101101110a1110011aaaaa1100111001011111110101222221111221212122221102a12011111
20211222220101221121001112212012201022021122210021221120111011110111101111110100110111101111a1111101b22120112212211102112112112120101100111211202212211ba1011111
21002002211212201021020110210201221011222020202022201112111111100111100111011111001111111110a0110010ba12100101020221222012101212221220222011201121110212bba10111
10102212121122201221111202122211202111122111202110111202111110001111011110010010101110110001aaaaaaabaa2220010012212201211011022001010220121121122111112122b11100
1212202101100021102221120222221212010211122122122122120010111011111111111110111111101111111111110211011000121200220000121222021221110222212220220222112122b12111
2221112010111020012122102222020120221121122011121121012110110111100111011001011111111111110011111112012111212111102101120202111122222102122221201201120101a22111
012212120221200212211122122222100111222122121012100012120110100111111111111111110111101111011111122120222211120001210101221000202221100010202211212122121bb12011
111011111110011110111111111110002211111222221221122021111111111011011111101111111110111101111111111110021211120220022211222111021110210202101222212111201baaba11
10011111111101111110111000100110210202211201122020022012111111101111101001111111011011111111110112110112101111222111120222221102112211221111122112220aaaaab22a11
12211121101000101201212112112211112101222021211220122121111101110001111111111111111000010110100011212121122112221110120122011021012200110210202112221b1112a02a11
20102221002021101112011221220022221111012222212011101210111111111111111011111101111111111111111111122022222102210121212102210212102020202212021112212bbb22bb2a10
2212222201002202222122211212220211112122022120102002021111111101101011011101011011001001111010111222010200211211011221200012222211212201000211202210021a12ba2aa1
2112102111010122120221020201110122012012222121111122111110111011001010111111111111111101101111111211000222220121210222111101220121221020220220001211aaab21a121aa
2202200021222221110222111212012121202121022221021121110011010011111101110111100111111101100111111210111022210221021222210110122212112211022211110122a111bba2201a
0222222012202101001022021222122121122002222212222111210101110011010111101110111101111110101111001212111011112202100121021202122212001220212112121011aab1b102001a
111211212022021101100110222222212222212112222112110021221111010111010111100111111111111011111111122101021112222120110221011210210212202102202212111222bab2112111
1212222112100101220221212112111021221112222002221011022111101010111110111111110111011111111110000122222220222022122220122122222221011002100110222222112212022011
0200101221022210211022122212122122101102221121021222221211111111111010111011111100101111110111101012220011101122112111221011112212222222010020122112212121201011
2212222221100112220110121201002121111200212110222202122211011101111101101111111111011011101111010210221221111112011212211211112201111111211201111111011221200110
1111212001221200101122221211221221202022112211222121222111111111111011111010111111001111001110011222210101110211102012220221212222121010222022220022122121201011
0022111011111222121102121210110211220121110112112111211211010111110111111110111111011101111010111022110022110201200220210201112211122221202221111111211101112110
1200112222202121112121211212211001020200112111222221002210110111111101111111010010110111111101111011111101201112112101221211001001112202200202112100012220212011
1022212201222201222201000211211121222201111211021122122110011111101100111110111111111111111111100210201022211211210112100110202010102102111212120012201021202111
1021010022102201212112121211021000221100221210022220211101001110111001011010111111111011110011011211201201211102122212211202102010111101111101111111101111110101
2102010001011210222210212121012111022100211222210012011201101111111011100111110111111101011110110220121121112212002201102222001111100110001110001010111110111111
0121011122221211222110210122102202221102121021111220021110101111110111111111101111111111111110101211201212121122102101000201221211111001101111101111111111111011
2010112022112221000112112200002221011021012120212220111201111111111011101111111111111001101111100112210222111020111120212201102211111111110011111111110111111010
2121220011122120011222111020122122212211121120210120112110000100111011111110111011111111101101111212221120111122120210221211211211111110111111011111110111111111
2111222201012012202220121221022102222202121221012212212111111111100111011011001011110111101111011100022221121201202202010212100211101111111011111111110110011011
2202222221022120011111122210110111111111111101111100111000101111111011111101111111110111110110111202121221220022120112102101010011111111111111011111101101111111
2121110221011022211121111011111111111111101111011111010110111011111010111111110010110111111101001222221212121221212221120112011210110111001011110111111100110101
2211221111011101112201212110111111011101001101111011111111111110111101111010111111111111111111111221212112210011221211010001222110111110011011111101011111101101
0012211222011110012021200211111111001101111111001011100111111111011110111111110011111110110100111110111101111111011011101011111111111010110111011011111111101101
2211211021012101222221111111011111011010110111110101111010111111111110111101111111111110111111111111001111111111101111111111111110101111111111100111010111111111
2022022220122011102222011111111010111010111111111110110111001111010000110011001110100011110110111011111111101101001111111011011011111111101001111000101101111101
1022210211121220021101210101101011011000111111111111000100110101111111111111001111111011011101111111110100111011111011111011011111110111111111111111011111111101
2001220201222122111222211211001111101011111011100111011101111110111111111011111100101111111101111001111111111111111100011111011111001111110111001111011111111101
0220221102021112011002112210010011111111111111100111111011110101111111110111111100111111111111011111111111011011111111101111111101111011111111101111110111111001
1122022012110221112202211210111111111111111111111001110011010111101111111101001101111100111111111010111101011001101101011111111100101001111011011101101111011111
1000102212220012101102222210101111101111110111101111011111011111110111111011101001111101111111111011101111101101111111101011010111111111111011111010010111111111
0111101111111111111001111111111111111111110101111111111111101101111111111111011110110011111101111111111011101111110111100011111111111111101111011111011110100001
1110111011111001111111011011010110111111101111111110101111101111100111111101101111111111110100111011111111111110010110011111111100111100011111111111111111111100
0111101111110111110111111111110010111111111001111010100101111111111011110111011111111001110011111110101100111110111111111110111111111111011110111111110111110111
1011111011111111110111111110011101111110011110111101011111111101001111111110111101011111110101111110011111010101111110011111111011110111111111111111111111110101
1111111111110101101110110011011100111011111111111111101101111110111101101011101111100101111101011111111101010111110010111101011001110111011011111111110010111111
1111011110011011110111110111111111001111111111011111011111011101111111111011111111111110100111001011011111011011110011001111111011011111111011111100011110111111
0111111111111110011111111010101111111111000111100011000111111110101111101111001111111001011111101011111111111110111111101111111111111110111011011101111110111011
1010111111111101101110001001001111010111110111111110001110111111101111001111110111011000111111011111111100101110111111111000101111000110011101111110111110111111
1111011111111111111111111110101011011111101111011111101111111111110011101111111100111011110100111101111111111011101111101111110111111110111101111101111111111111
1001101100110001111111101111111111111101111110111111111011111111111111111110111011111101101111101110111111111101111111111111011010100111111011011111111111111111
1111101011101101011101001101111111111001111110011111111111101111011101011111001101111111111111111011111111111010101101111110010001111101010111101011111111111111
a111100210220222021021122122220221211011100111011110001011111111110111110101101111111110111111001111010111011110101110111111111110111111101111111101000111110111
a110210201121201212002100200111211211111111111101110010001110101111111111011101111111110111011101111011111011111101111011101101110001110101101111111111010111111
aaaaababaaa11222211122222220122221211111101010111110111111001101111101001110110110111111110111111111111111110011111011111111110111011111111111111111111101111011
1010211121a22121011210000201211122211111100111111101011111011111101111011110111101111110101111111011111111111011011111111111101110111111111110110011010011110110
1111220012b02202111112201112111011101111111111011101111101100111110111101110011101111101110001111010010111111111111111110111110110111000110111111111101110110111
2210212200a22020012122112211112121111111011111111010111101101011110101111110101111111110101100110111011111111111111111000110011011111101110111110111111110011101
2221021202b20221222022202211211121011111010111111010101001111110001001111100111110111111111010010111101101011101101001101111010101111110011010110110101000101111
2121221222a121221bbb21221211221012211101111111101110110111010111111111101111111111110101101111110111111110011011100110101110111011111101111011011110111111100100
0000221012ba01211b0b02202102121102111111110101011011101100110111101111111111010111001111101111111001111111111111101111010101111111111011100111011011101111001110
02210102222b20002b1b02120222011120001111111001110110111101110101110110111110011111111111011110110111111110111101011111111111110011111111110011111100110111111011
12211221002b22210b2b20222202222000010111101101100111111111111011111111110111110011110101111111111111011111011110111111111100011111110101111011101111101111111110
21010202120bb2222b2bb0222212112112201111011111111111111111001011000111111000111101110100111111111111111111111111001111101110000000011111111111111111011011111111
211111002022ababbb01b2002011122202111100111111111111111101111110011101111101110111110111110111110001101100111010011111110111101110011101101011111011111110001110
12212201022112222122b1020222201200201111101011011010100111111111111101110101111111100011101101011111110011111011011111001110111111110110111111110101011111110101
bbbb2120121212120211b0222121022201111111111110110111111111101111001011000111101111010111011101011111111001111111110111111011111111101001111111110010111111101001
112abb22122220012021b1122012012222211010111111010111111101101111011110111111011111111110111111110111110001011111111111111100111110111001111111111111100111111111
112abbaaa12122222202a2222201111020110011101011000011111111110111111011111110011011101011110111010111110110100110011111111101111011111100111101111001111100101100
212abbb1b20212222222b0200210202100210110011111110011111011110101110111110110111111101111111111110111011100011001111111101111111111111111111110111110111110111111
010aa022b21112202011b2222212111211201111101111111111111001111110100111110101111111100110110111111111111110110011001110011111100111110111011111111011011001010111
12022222a2abbb222220a0222102222210100011101011100111011110111111110100101111101111111110110111111111100111111111111111111111110101011111111111110111011111110111
10212221bab02a222222bab20202101022211010111111011111111111110011111111110110111111111110111111011110111111100001111110111001111101101101011111101111101111110011
1111001222222b21212220a12212112022211111111111101111110011011010111101111110100110010110101111110111111110110111111111110111101101111111101111110111101111111011
2211022222222b12022222b11012121220211111110111011111110111111101101110011111111100110111101111111110011011111001101101001011111101111000101110001111101101111111
0220202211202bbb222012a11212121201201011010011101001011101111111111111011011011101111110111011111111101011111111110111011101111110111101111111110111111110101010
001111022222222b022bb2a02222112122211111011111011111011110110011101001111111110111111111011111100110110111111101101101101111100101111111011111110111010110011010
102122222122221b212bbbb21201011201011111110111111011101100111111111111110100110111111111111111111111111110111111101111111010111111010111101111101111111000111111
110102021221221b021bb12121202202211010110110111011111101111011011101110111111110101111011110111111011111111010111111100aa111111111110111110111101011111111110111
011222012022222bbabbb20222011202211111111011111000000111001111111011010111111111111110110111011101011111111111010111010aaaaaaaaaaa001011011111001111111111111111
12112211212022001211220022010120211110111111100111101111101111111001111111111101111111111010111010111111101111101111011a001111111a111111111111111110101110110111
11022222022222120012222221111010120111111111011010111011101100111000110110100111011111111111011111111000111111000110101aa11111011a111111011101111110101111111110
010112121122122200222112122002011220101011111111101111111111111011011111101100110011111111101010101111111111101111110101aaaaaa101aaa1110111011111011011111010111
11222022212211222211100112111100111111111110100101110111110110111110101111010111110111110111111011011111101111011111011111111a11111a1110110111022112000222212022
10112122200222121120211001111111010111110111101100110010110111101011111011111011110111001110011011111111111111111111111111111a111aaa1111111100222221111002222221
00111201001122021102212022111011011101110111101111111111101111111111110111011111101011111110111111111111111011111111101111111a111a110110111111111021211011211120
11122212012120201111011212111100111101001001101111111110111011111100110101111111111111110111110011101101111011100111011111011a111aaa1111111111202110001212222121
22212111212022122221222022111111111111111011101011101111110111101011110110111111111111101111111111111111111110111110101101001a11110aa110111111122110121011200102
11110110011111011111110111100101101111111111010111111111111110111111111111110100011101110011011101011011010111110011011111011a101111a011100011112122102222221122
10111101101111110101111111101110111001001111101111111011111111101001110111011111111111011111111110111111111100111011011011111aaa0101a001101001021120112002220100
0111111101100111010010111111101110011010100111111111101011110110111111101111011011110101110010101111111111010101101111101101111aa111a111001111222210221112121210
11111111111111111110111110111111011111110111101100101011111111111111111101111111101111111111111111001111111111111111001110aaaaaaa111a110111110102201100220211000
11111111101110110111111111100001101111111011111000110101110111010111011111110111111001111111110110111111001111110111000011a111111111a110111111211201212022010211
101111111010111110111111101111100011111111111111111111111101111111011111111001100011011011101111011101111110111aaaaaaaaaaaa1011aaaaaa111101011121112220221110222
011110110111111111011111100111101111101111111010011101110111010111011111111111011100111111101111011111111110111aa11111001111001a00010111111111120211221211121122
1111101011111101101111111111111111111001010111111101111111111110101111111111101000101111111010111001111111111111a11101111111101a10011111111010222221122012011101
1011011001110111111101111111011111111110111100110111111111101111111011111011111001111111010111111111111111111011a01101111111111a10111110101111100222001212221011
11101111110001111111111110111101110111111101001110111111100110110110111011011000111111011110111111101111101111aaa00111111011111a11010111001110021110112202201112
11101111100111111110111111111111111111011101101000111111111011011111101110011111111111001011111011011111110111a1111110111111110a11111111111111112022021022211101
10011111111110000101111111111110001111011111001111010110011110111100101110111110111111111111101011111111101100a1111111101011111a11111111101110001120121221221201
11111011111111111011011110011110111110111011111101111111111111111110111111111100110111111011111111111010101111a1101101100111111a11011111111111210211122211222221
11111111110111111110110000111111111111100111110111111010111111010011111111111001101111011111111000011111111011a0111110111111111a01111100111111202211221121210010
11101011111111011111101101111111100110111101011111111111111101111011011111111000110011111111100101111010111111aaa11101111011111a11100011111111100221110110022201
