1,13
145,2
44,64
34,65
55,81
12,38
84,8
17,105
146,51
69,111
111111aaa1111111111111110111111a11011001111011010110111111111111111111220002110111011102212002022120110001111111111110110011011111011101101101111110111111110010
010101a101111111110011111011111a11010010101111001111101111101111110111201101112211212120020221011212111111111110101101110111011101111111111111111111111111011110
111011a111111101111111101011110a11101111101111111110111011111111101111112221022122202120111100111000111111101011111011111111111110111111011111111100110111111111
111001aaaaaaaaa1111101111111100a01011111111111111111101110101101110110102012222221101010210121122222101111110111111111010111111101111011001101111111011111111110
111111111aa011a1101110111111111a01111111111111111111011110110011011011121022021221111212110120021212101111101011111111111111110011111101110111110110111011111111
10110100111101a0111111111110111aaaaaa111111111111011111111111101010112101100011110221011021211212112101111011101111111111110111111111100101011111111111111111101
01111111100111a111110111111111101111a111111111110111111111110110111112211221202022111222102102200212010111111111011011101111011101011111101011111101101111111111
11111111010111a101111110111111111010a111111110111111111110111111011112200122211111002220121112222001110001101011111110011101111111010011111101101001101111111101
11010101101111a1001111101111111aa101a101101011011111110000110001010112210021111101222101111112002212100111101111110110111111110101100111011011111111111111110111
11111111101111a111aaa1111011101aa101aa11111111010111101101111111010110201122212002101110121121021001111111101011110111101011111001110111111110111111111111111101
10011011111aaaa111a1a1111111100aa1101a10111101111110111011110101111112210120122111112121202121221222111011010011010101110011010111111101001111101011111011100111
11111010111a111101a0aaa01011111aaaaa0a11011100111111011111010111111012212220220211111121120221222222111111011111111111111011111111111111111001110111100110111111
01011111111aaaaaaaa11aa11110101a101aaa10111111101110111111110111011110111111121220122121020112212100000111111111111111111110111111011101101101100101010111100001
101111111111110011100a111101111a0111aa11111110101100101111111011111001221212020021220211222112002021111111110100011111111001111110100111011111111110111111110111
101111011111101101111a1aaaaaaaaa10111110110111111111011101011111011101212220111101110220220210122201111111110111011111110011101101111101111101111111001001111111
110111111111110111110a1a1011111101011111111111111101001011011111111112001012112201012122220121111221111011111111110111110111111111011110111101110111111110101111
11011111111111111001aa0aa101111100011111111111101011110111111110111110101012210222120101011122212212111111110111111101111111101111111011110101101111011111111110
10111111111111010111aaaaa111110111111001111101111101101111111011011112211202211211101212011111011111110110101111111111001110111111111110111010110101101111111111
1111110011011111101111111100111001111110111111111111100111011111011111111122211111111110112111101011111111111101111111111111111111111110111011101110101110110011
1111111111111100010110011111111110110101101011100100111111111111111111021122112210212200202020112122111110101111111110111111111001011111010011011111111101111111
1111111111111011111110011111111111110111011101101100101111101110111011211112022010110212220222011022111011011000111101111111101011001111110110111110111110101111
1000110110111101110111111011111101101111100001110111011111111111111010001201011221111101011021221101111110111111111011011111100111111111111111111110011000111011
1000101100001111111101111110110111111110011001011111110101111110110102221202210012121202022212001102101011111101111110111111111111011111110111101101111110110101
0122122121000210221210202121111101001111111111111111011101111110111111201002212122221210112121220211111111110111111011101111011011111111111111011111111111111111
0120011111111110020122112212101110111101011011101110111111100111010111100111011111111111111111010111001110101111011111111111111110011111100001111101111111111111
2122021001220011010002221011111111111101111111111111111111011001111111101111111111101101111101110111111111111111111111111111111011101111111110111111111110110011
0221220221122122212012221210110110111111011101101110101111110111111011111111111111111011101111011111111110111111110110111111101110111111111111111101011111110111
0211201112221212121111221110111111110111110110111011111110001001011001111111111110011111100111100110111111111111111111111111111101111111111111111110111111111010
1212210111211011221211100200101110110111111100110011111010011111111111111100110010101101110111011111101110111111011110011011110111111111111111011010111111111111
2100122011202021122111012020111111001111111010110111101011111110001011101111111111011100111111111111111101111010101111110111011111011111111101101101011111101111
2122221122212221222211201221101111011111111110011111100011111111111011111111101110111111110111111111011101101101101111001111011111111111111110111111101011011111
1200121001122221212200200122111111011110101110101111111111110100101001101010111111110111011011101011100101001110111111111110001010111010110011111111111111111101
1012201112111220110222211021111111011011111100111110010011011111001111111111001111111101111101101111111101011111111110110001011111100101110011101101101101011111
1020011202220110121122011221111010111001111101110111111111111111011010111111111111111011111110101001111011111111111111111011111111111111111011111101111101101111
1011012120021221012220202221111011111101110110111111101011111111110111110110111100110011111111111101111111111001111111010111111111111111100110111011111111110111
2212200020110221210111222100111110111111111111101111111110011111111100111111001111101111100111111110110110001010110111101011011011010111111101101111111010111101
2021111220211211012212021012101110111110111001111011111111111111110111011110111111111110011111110111111111111111011100011010011101122200212221110011212122122020
2111020211102210102222012222111111010111001110110111110011111111111101111101111011011111111111111000101111111111011001111111011011102112221211110211001211110110
2121202101112221200020111112100010111101110110111101111111110111011011110111111011001011011111110011011110100111011111111111101101102111112002021111120baa202211
2021102221020011212022221221111011110111100010111011110110111110111111111110111111111100010110111011111111111110011101111101110011121211202220211112111a0b211020
12021112012221121112212112210111001101111111111111110101101110001111110111111111111101101101111111111011111111111101111111001111011002221110110201111bab2aaabbaa
12112221211121200000211121001110111111001111011111110111011111111111110111111111101111101111011011011111111011111101100111111101111122122212221221111a121aa1111b
22021122001101212002001112010001111111001111110110111111011110011110111111110111111011011111111000101111011100101001111011110111111120221202122110202b211221210a
11222110011212120021210221101111111110011111111111111111101110110111110111111110110111111011111111111110011111011111111111001111111211222202100121121babb1211202
10121112110121011212212021110111110011111111001011101110101011111111110010110111101011111101110110101111111101101111111110001111101220201120120121122202b1022212
01102202011212211112122222221101100001111000111111101101111110111111100101010001111011111010111100111001011110101010101010011010111222102212221220212020a2001202
20110222221021121120001012011111111111011100011111011011001011011110111100011011110110101111111110110111111111011111011111111111101111202102111120021012b1221212
20201101012120101120011202200111101111110111111101000111111111101110010110101111110111101111010110011011011110111111111111111011111012211122222221111212b2110201
11222000001002200111112012101101011111010110101101111111111111010111011011110100111011111111101111101100111011110111011111111010010122022222122100122221a0112112
02211121122112212011211112020211012120011021012121212122001101011000111010111101111111111111101111110110011111110111101011111101111101210121211100211122a1221211
01212112212022012121001221221020212001211212111221122101120000111111010101011110011111111100111111111111010111001001011000011111111112120111011202012211a0110111
11222020001212120120211112222022222222202221220122110002020011111111111101010110100111110111111101111101111111110011001101111111111221122002101212110210b1121122
122111201020021222002022222220201200200102221212202112021212111111111101111111110111111111101111111010111110111111110111111111110001002222122122202212bbb0101221
212121122111201122222221012010221021222221201201121221111112101110101011101111111111101111011111111111101110111110111111111011001101021202200002011220b11abaa112
111111111001111111111122102122022021222210210120100012221220001101101111111111111111111011011101110011111111111111101100111110111112011101201202222022a21b02a201
110111100101111111121121122112022222222222012122221202120111110111110110111111101101111101111011111111100111111110110111111111011011100202201221201211baaa12b021
111111101101111110111221102110122112222210202121121021012011011111111011111001101111111111011111111111011111111111110111111110100112211222121011120201111212bbab
010110001001111100122111210001102022222212221122222120021011110111011011111101110001011010111111010010010001111110111011111111001111211111222122121012201222ab1b
111011001101111111112121102212012122010120210121222010010021111111011111101101110011111011111101011111111111111111111110110010111101222201221122122000222221ba1a
010110111111110111012011120201222202222202201211222212122102110111111111111111111110111011101111011011110011101111111011101111110111002222112221201001020112222b
111111111111111111122121102222121202111020212220201020110210111111100111111111110111011000111111111111111101111111001111101111011101212222202210211022111211221b
001111001100111011120122001202002022121022222202222021121111111111101101111111101111011111111111011011111111111111101011111100101102021111121210120112121211211a
11111111111011111102120112121222020222211212220121211120110111111101111101011101011011110111110101101011111110101101111111111101101212122021202101222121010ababa
11011111011101010111120021122220222022220111022222220120211211111111011001111111111001011111111111111111011111111011011100011011110120222011000200112122111b1211
01111011111101011111210021121210222001202212122220211201220210111111111101101000011111110111101011111111111001111111101111101111111211220221122101110221122a1012
11111111111101110112221001222022202202210221100201201211101111111111111101111110111111111111111111011110111111111111111111111111011200111110212221111211121b0012
01011011011111110102121212221222111222202222122222222212211222012102212001110100110101110101111101111111111111110010110110111111111111102221211120222221122b2110
1011111111110001110212121112020201212110002220010222020012120221121020010100111101011110011101111111101000111111110111111011110011101111101111111001101aaaaa0111
1011111111111111111210210022122000001112002222121202002211220020212012111011111111111101011011011111111111111111110001011101111101110111101100111111111a11aa1101
1101111111111111111112201221122221220122202122022220021222211112101112111110111011111111111010111000110111011111111111111101111100111011111111111101011a11aa0101
1011100110100111011211012121220222210211202222022202120110021002012120011111111101111011011111111111111111111100111111111110111111110111101111111011111a11aa1111
1011001111111011110211201211220222102002221202220211202020211110121100111101110111101101011111111010011111100001010111011000110101111011111110111110111a11111111
1111111111101111111212001211020222211220002200222222212122112211102001100111011011110111111101010111101101100101111011111011110001111111101001110110110a11011011
111101111101100011111221122212112212222220222220202022212211112200020121111110111110010111011101111101111011110111110001111110111111110000111110111101aa11110011
001111111011111111121021121111222022122202002122222120222220021211121120011111110011110111111001101111111001101011111110111111101011011111111010011011a110011111
111011111111011110102221101102200222220202202120121122222210121121212201111110111011111111111011010110011111101110101101111110111111111100111010111011a1aa111110
111111101111001111121110220212100022221221221222112201001121101110122121111111111111111111111111110111110111111110011111100010111111110111101101100111aaaa011111
110101111111111111110122011012222220212222222022202112211211201212212211110110111011111111011110011010111111011101110111011011111111111101111111011110111a111110
111111111101111111122121021220220202122210122022220012120220221111122101101110111111111110111111111101111101111101111110111111010000111111110100101011010a111111
111111111111110111112212102122221221212022222220122202122210002202222221111111010101110110110111110011111101000111110101111001101011110111111110111011101a111111
100111111111111001122221112201211121220102222220221221112111111021111221111111101111111111011011011111001111111111101111110111111011111111111111111111111a111000
11aaaaaaaa11111111111111111111011101111020220221011001111112211011121201111111110010011011101011111111011101111001111110101011001111111011111011101111111a111110
11a1110aaa11101110111111011111111111111122212202111102222011210212122221111111111111111111111111110111110111011100111111110011110111010011001011101101111a111011
11a1001a1011101011100111011010111111011022122222212122121202111122100121001011011101110111111110111111111111111111011111101011111111000101111101111111111aaaaaaa
1aa1111a1111aaa1111111111011111111110111020201012022012120221110210201011110111111101010111011111011111111010101100101111111011101110100111101111111101000010111
1a11110aaaa0a1a1111111110101101110111110011211222122220212202112121122110111101111101101110011111011011001011100101001111011100011111110111111011001111110011001
1a01001111a1a1aaaa1111111101011110100001201211222220222120101021110021101110111111111111101111111111011111100111101111010011011111111111111111111100011010111101
1a10111111a1a1111aa101111011011011111111110110221222111221212112220121101111101111110001100010100110001111011110111101101001110111111101111111110111001100111111
aa00110111a1a01111aa11111111111111110011121120122111200200202221201122211001110011101111100111101111111100101101111111111100111111111111111111111111111110111101
aa11010101a0a111111aaa111110111011111011222022020102111200201222200121201111111111110010110110101011111111110010011101111111110111101111111111101110111011111011
aa21120222a1a21211121a120112120121110110212122111100202022121222102122011111011011110111011101101101110011101101111110111111111110111111100111010111111100001110
1111122000a1b11201122a012122222111101111212012221111222120211101110121011110101101101001111111111101100011011111111111010011111011011111111110010111001101111111
1121022120a2a20010000a101122012020111111211022210101112220200000211110111111111110111011111111110011111111111110110110110010111111011111000001111111111111111111
1022000221b1a02121200b100211012021101101210010101021121100020110220111011111010101001101011111010001010101111111110111110010101111101111111001110100111111111111
1120112122b1b11222211a102202221200111111221001222102101122202112110201011101001011111111101111011011111110111010001111111111101010011111111011001110101101011111
1122221211aba21101121a221200112201101111111201112102021221222122222121111010111100110111111111011010010111111100111111111100001001101111111010011111111111100111
001011000200011111011baba201221111111111122221011202122211221200222122011001110121121110110111111111111111000111111110111110111101001111111101111001111101111101
111100222211000211102022a121202121110111001111111110111111220111221122211110120122101111111011111110110110111111111111110111110111010111111101111111111011111111
112002021102001211212110abbba22221111110111111101111111210210111201222020001112122102011111111111011011111011011111011111101111110111111011111111101111111111111
1112111111210112102211010222b12211111101100111111111110101222110120102121120100222212010111011101011110111111011111110011111111101101110111010111111111011111101
1122101201222122122120010101a21211110101101111111101012101100211122022000001222221110011111101111101111111011011011011111111111101111111111111111111011111101100
1120121121211010221211122122a21100101111111111101111111210120011012022100111222211220111110110101111110101111101110110111101111011101001111111110101111111111111
0102100221112202122222222212b22110111110110111011011102222101011aaaabbbbaa12011200122011111111110110111110111111111101110111111111111011101111111011011111111111
1101001021211221221012021212a11121111111111110001111111000122110b00020220b00221122202111111011111101011110110111111010001110101110111111111110101111001111011010
1111210120122220112021212122a22100111111110111011110111101102aaba02101221a22212112101101111111110111110101011011111011101110111110111010111011011001111010101111
1121112011122221201002011200b02110011110111101111101111220201a21210220221a11212220200110111110111111101011111011111111111111111110110110111111101111011111011111
1100021210021211012212222222b02210111111110001110110112021110a11012222111a12012110122111101011111110101010111101001111100101011101110111110011111111100111101111
1010221201221111022111110111b11210011111010111011110111021110b10211122212b22222112212101100111111100111011111111111110111111101111111111111110111110110111010110
0121110011201102111121001110b01111100110110111101111111222122a20100012101abaab0011211111111111111111011111110110111011101111110111111110011101111111011011110110
1120221111200211112012001201a10110011111111111111110101200110b222001022111210babba021100001111111101111111111110101010111101100111011111110111110111111111111010
1112110112220011220002122122a22111111110011111011010110021222b22212122022aab12211a021110111101111011011100110111111111010111101110111111101111001011111110111111
0111112010122101020022111001a02101111111011011011111111120211bbb112ba22bab1a20012a221011111111111110011110101111101111111111011101111111101111111111111110111111
1110102211121121222211211120a11221011110100011111101111201222aba112bbabb112a0101ba211110111111111111011111110111100110111100100110100110111100111100101111101011
0020001011210211212102022112abb211101111110110101110112211211babbbab2201112a2101b1011111111011111111101110111001111111110100110110101111110111011110111110111110
112211122222222002102201122202a11011110111100111110011122012222221122010202b1011a2022111111111101111111011101111110101101111111101111111111110111110111101111100
000021120110020202200022212212baa111111110111011111011210020222021201122211a1211baab2111111111111111010111011111110101111111111011110110001110111111110101111101
11121121200222220222101001111111a11111011011111011101122011200120211221002ab22110aab2111110111110111100111001101111011001001110111010111011111000111111110111110
11021100202022121111211022020111b11111111111111110111102221201111002000001b201210a011111111111111111111110111101111100011111111110101111111001111111111111111111
01100121222122002221222101112221a10111011111010101111102001211121021babbaaa212202a221111000110111111110110111111101111111111110101111111111111101111111110011111
11211011222000222122121222210002b10011111101011111111121012202012112a010122220201abaaaa1110101111011011001011010011011111101101001111111110010110111111101111111
