2,106
143,110
33,52
99,111
29,110
127,80
70,85
18,96
87,14
127,92
0011111110111110111111111010111101101111101101111111101111011111111111111000102112212212112aaaa1122221111111011011a111111111101111101011111111111001101111111111
1011111010111100011001111111111101111111101111101111011111111110111101111221211111102102221ba012202211111111111011a111111001011111111111110111011011111011101001
0111111111111111111111111100111111011001010110110111101111111011111101110111012210211212012ab111102121211111101110a111101111111110111011011010111111011111110110
0111110101011100000110110110111111111111111111101111111000111111101011112212121221212121022b0101201122111111111110a011110111111111011110111101101111110111111011
1111011110110111111111011110110011111111010011111111100111111111011111001001212012221202112a1021221122201100111111a110010111110110111101111111111111110101101011
1011111011111011111110111111101101100101101111011111111011110111101101011222010112222111012bab1aa12111110110100111aaa1111101110011011111111111111100011110101111
1111001111111110111101011111011110111111111111111111111110111111111110111222111021102110211ababbbbaab210111110111111a1111111011111111111111111101001101111111010
1111101101110011011111111111111111111011101111010111010111100101011011112210111102121102202aa011bb22bbbaa011111011aaa1011111111101101111001101110111101011111111
011111111110101111110111111101111101111110111100111111010111111010111111111002200102221222021222ba212211a011010100a011001101111010101111101110101111110110100111
11111111111110111111111011001110111011110011111101111110111101111111111102202120112212121101012001112210a111110101a111010100111111110111011111111011111101011111
10111110111011111001111101111000111100101111111101010111111100101111111002122020111120121012221021111220a111110101a100111111110111010111001101011101011111101101
10111111111110100011100101110110011110111111111001111111111111111111111100011110212221022211020211110211aa1111111aa111111001111111110111111111111111011110111111
110101101101111101100011111111111111011111110111100111011111111011101111222221020211200211102221211201111a111001aa1011100111111011111011111111000101011111111111
111111111111011100100111110111111101101111111011111101111110111101111111112122022121001201112211111120011a010111a11111111111111011111011001111110110111111111011
101011101011000011010111111111110101111001111101111111101111111111101111211120211001001212211202021212011a0101aaa11011111011100111010101011101111011111110111101
001010111111111111011010111101101111111110111111110111111110111111101110021121212212222121222111002222210a1110a0111111001111111111011010111111111111111111111101
110111111111011001111111100101001111101101110101010101101011111011111111121211112021102100012110100100011a1111a1111010011011111111011101111101011111111111110111
100101111111011111101101101001100101111010111111011100111111001110111111201221200120112221201121122011aaaa0aa1a1001110111111111101101111111101111111110111111111
11101101100101101111110111101011111011010111011011011011101111110111011102121122210202100120210010021ba1100aaaa1101111111110111111111101011111010011111011001111
10110111111111110101111111111111111101111111101111111011011011111111011122112211121121221022122011011aa1111aaa11111101111011101110111111000111101111111111100111
111010000111111011111110001111110101110110101011000111011111011111111110221212120021102110122001212222b0011aaa11111011111011100101111101011111101111011110110101
110111111111011101111111111011100111111111111110111111101101111111011111220220010212222212012022221110aaaaaaaa01100111111111101110111111100011111111111111110111
1101110111111110111111111101111011111000110111110111100111111111111111011201110202211121122222212211120100101111111111111111101111111101101110011101111110111111
0011101110011111110111111111110101110110000100101111101111011111111110012222112110212021202211221200220111111111101110101110111000111011011111011111111111011111
0111011011111100111111111111111111110110111100010111011111111011110010002221222021102002122202211120220111101100111111011101111111110111111111111111111110101111
1101100111111111111101111001111111111101101111111101111111111011110101110112102221102120210202112112102111111111100110101111111111111100010111111110111011011011
1111111111110111110010101111111101101101111101111111111011100111111111101211122022221212002201122002112111111111101111011111111011110011101110111111111110101111
0111110110110011101011110111111111111010111111101101101011111100111111002211222221221120121122121112012111110111100111101111111110111101011110111011111011101111
1010111111111111111110011110111111111111001110011111010111011111111111111220112202211012120211122220010111011111111011111111111010101110011110111111011111111111
1111001011111111011111111111111001111100111101110111111111101011010111111201112110222120010212122122202011101110111011101110110010111010111101111101110111111111
1011101011111111111101111111101111111111110111011010111110111111101011111111110001111110101111111111101111111010111001111111110011111011010011110011101111011110
1101111111111111010010110011111011111111111111101100011111011111111110011111011111111111111111100111101110110111111111111101111111111110010111111111111111111101
1111011111110111011111100111100111111111111101011111110110111101101011110111111011011111101111010111100111101101111111111111111001101100111111111111110111011111
1110111011101111111111111111111110111101111111110111111100111111111110111111111100111101111111111111111111111111111011110111011011111011111111100101100101011111
1111101111111111011111100111111111111101011111110111111111111111101110011001111111101101110111111110111111101101111111111011110111111100110111101110111111111011
1111100111111110110011111011111110011111110110011111010101111111111111111111110101111011111111111111101111111101011011111111101111110001001111010001111111101111
1111110011010001111111111111111101111111110010000011111010111011000010111111010110101111111111111111111110111110111111111111111111111101111101111111001111111001
1111110011111011111201211211211211202201012120111111100101001111111011000111110111001011111011001111111111111111110111111011101111000011101011111111111101111111
1011110110111110011212121122111221121201212002111111011110111110111111111110111111001111111111111011011111110110110111111101010011111100111101111101110110110101
0111100100111111112111001022110211202111102211212001011011111110111111010100101110111110110101111111111110011111100111110111010101111111101111000111111011111110
0111100010111111112020200202220221121222121122221110111111101111011110101100101111111111111111111111111110011111110101111111101111101101011111011101111111101111
1110111011111111001222112222121202210221222211211110101111110111111111111111111101111111010111011110111011011011101110010111111101111011111111110110111111111111
1100101111111111112211001102001021222200012112202101111111101111101011111101011111111110001111111011011101111111111111111111110111011101111011111111110111111111
1101110110111111112111211222222122022212212110110011101111111111111111111110111001011010111111011111011011110111111011111100101111011111010111111111001111111101
1111011111111111112210112110222222022112222022222100111101111110011011001001000011011011011111011111101111100111011111111011000001111011101111100101111011111110
1111111010000111112212211220221122112101211012122011101111110110010011111111011111110010101101101011011110001011101111010110101110011111011111111111111111011100
1111110001100111111111201200112211111122211122121111010111111011001101111110011011110000111101111111111111110101111111111100111111011111111110111111111110011011
1101111100111111110221101112102201011202210222122011101111101111001111010111111011111110110101111111111111001101111111111011110101111100011110111101111111111110
1101110110011111111101012122012122101020002110021011110111111101001111111111010111110111111111010111011111111111111111111110011111111111111111110101101111111111
1101011101010111111101122011212022120221222001210100110110110111110111001110011111101111101110111110111111010011110110111011011111111011101111011011111001111111
0111011011011110110102211111021022100011020200121100100111100111111111111100101111110111110011111101111111111111111110111110111111111110110110111010101101111110
0011011111111101111202102122212222011112121120121111111110111011111111011111100111111101101111101111101010100011011011111110011111011101001011111111100101111010
1011111111111110112221012112111201222211121122120110111111110101011111101111010101111100111111110111100011110111000011111110101111111010110111111101111101111011
0111111111110110112212011211220112020012211102211111111111011011111101101111001111011111110110111100011111111111111111011111111111111101011111111110111110110111
1111101000000111011212212221022220222201121122201111010111111011111111111111111010100111111111101111111101011111110110111110100101111111001001101011101110010101
1111101111010111012222010222220212222122022100112101110111110111100011111111110111110011011001111110110110111111111101110111111111011110101110111111101111011111
1001111010111100111011110012222212110022201200201011101111111011111111111110011111111010110100111101011101110111011110110010110001101111110101101110110011111111
1111111011110111110222021001012212111122022011111111101111101111111111101101111111111111011100011101111111110110001110110111111111111101101000101110111101111011
1111111111011101011021221112002011222112002221121101101111110111101110110101101111111001111111111111110111111011101110101011110111001111111111111100111011111111
1111111101110111111201111220012112021021202201222111111101111011111101110111101111101111101111011101010011111111111011111011101111101001110111110111111101110011
1001101111010111112211012102222010201021212021210111100111111111111001101101101111111100100111010111111101111111011111101110111101111101011111100111111110111011
1101001010111110110220012222122121112102101021212111111111100110100110010111111001100111001110111111111010111111111110111111111111110111111110011110101111011111
1010111111010011101101011121212122122222202200211001111101111111111011111111011001111111111101111011111111101110001100111111111110001111111011111111111011111110
0111111101111110111201022221211222002022212101210111111101111111110100010011111011110111111110111101101111111111101111110111111111111111111110100111011100111011
1111111111011110111112011221210102021221110101220101111111110101111100111101111111111111011111111101111111111111111111111101010001011111111011111110111111100101
011011101111101101212212222112202021010110101211010111111111111011011101111111001111101111111011101011101111111012211222212112101121012221212baa0111111011011111
1111011001000111012110221201102221222222020120222110111111110111011101111011110111111111101001011111111110110111100121002201222112201001220aab1a101111111aaaa111
0111111001010101111100001211111120112021220121001111111111111111111101011111010111111111110111100101111000111011120012021222122122222101112b000a010111111a10a11a
1011110111111110111111111010111111110111110101101111011111100111111111101011110011111101111111110101110011111001110121101222121020121121012b122aaaaa11111a11a11a
0111111110111111101111101010001111101101010110110111111110111111111101110111111111111110111111101110011111101111202120121121021001212221211a0221011a0101aa10a11a
1111111100111110001111111101110111111110111010111111111012201112012122212202011002222200010110011001111111111111112110121010221222212022121a2221111a1110a101aaaa
0011011111101111111101111100111111111111101101111110111222121121210211122221212110122111111110111010011111111110100110011022021202202221122b2111111a1100a1101111
1111011011111011100011111111010111101111111101110001011210120010211211122211122221022011111111110111110101111101212022200212111001201101212a1211111a1110a1111111
1110111011111111111111011111111111111111100111111101000120221000201211210102010111120211111101110101111111111111111101022221112122101101210a1121101a1111a1111111
0010111101111010001101111010011110011001010010101101111110111121111111110101202112001011011111110111111110111111001121221221212000211121121a1101101aaaaaa1111111
111011aaaaa01111111001110011111111100101111101111111010002110202211212021221101121202111110110111111111011111011210210112211212110211000120a10011111111111001101
000111a011a01101111101111011010101101111111111011111111220201221211012212222121201210211111111011110110101111111121022202201210012012212021b22011111001111111110
101aaaa110a11011101110111110101111101111100111101111110102101201112112011221220002202111011110100011111110110110122022020201022200102202222b22211011111011111111
111a010011aaa111111111101111011111111000111101111111110210201212200201010200022122012111111101101111110111111111222220002121012222210202221bbbba1111110111111111
001a11110101a111101100111111111110111111111011110111111201212221111102120102210210202211111111111110111111101111022221021220212022102222202222aa11110111aaaaaaaa
011a11111111a111011111101101111110011110011111111011111200021122222112211222112112010110101110111111111101011110002101212222121021001202120021b100001100a0101111
aa1a11111022b011111100101122222221101111111111110011110102002220102021102220012012122011010011101111101111110011222222122221212012220212222220baaaa10111a1111110
1aab10001100b2121210112211202202221110110111111101111111120200021112122121212102211110111111111011000001011010112011012222120222220002221221202111aa1aaaa1111011
111102202221b22121211112211011211011011111111110111001111222102221012022110112111212120111101111101101111011110112121222101202220222122222102121111a1a1110111101
111222011012b10210101202012211202001111111111011111101022222202022102220110122111012120111111110101111111110111112212102222212221102220220022101110aaaaa11010111
111211122112ab12001211221221210021011111aaaaaaaaaaaaaa0202120201212122011120221212221211111101111111011110001111011122011202221221012122221202211110a01aaaa01111
1112021110012b12212102100210001022111111a111010001110a0011112122021102222111110120222211100111111111111111111111002112122122221202000222021220210111a1aaaaa11110
1112122101121a12112110102111022212111111a111101110111a0110222111022001100211121211101211110111001101111111111111211202212022222202222222021222210111aaa111011110
1111112112120ba2112120001112212120101011a10111aaaaaaaa1001000120102222121121011222201101111101111111101011101001222020220211212220200202202222101110111111101011
11120100122202a12100122220122011201101aaa10110a01011010222022010110022011222002211221111111110111011110011111111220210221202221222020202020001211111101111111111
10111110012012a11111211212112201221111a1111111a01100111202221212222222220212100212010110000011111111001101011111202222022212202022011221222122210111101111101011
11112221002112a220112121112102222211aaa1111111a11010111201220221121222022222022122120111111101111111111111110011222021210222212222211222121221211111011111110111
11011220122122a011112122120101202111a010101111a10111101221121121002111020222200200212011111101001111011010110111120001220012001222222122211221210111110001111110
11112201221121b021020202000212220100a01110011aa11111111220211122022112021012220101222101011101110111110110100111122012122222022011000021222220111111111111110011
11101022122112a202122122101110211211aaaaaaa11a111111010120120120221201101111102210222111010010110111111111010111212011020220200022222210022212201111111111111111
11102112122111a222120201221102212102002212a21aa01111101210002110221202200110112001111101111111001111111110111111202021102202211220221120221222211011111111011111
01111110001021b122222122101202202221021211a000a11111110000121012021101212121211102011012221011222212122112002102020010211202212122111101002120011111010111100110
10122011112012b221221102021222022212011000a211a10110101202211212221122111221211010020220222221100122201110122102002201111211222200002121012102110011011100111011
11111212121222a212122222122110022021122112ba00a011aaaa1111222122222022111122100021201212021112122211101100102120222220110020221211021012121221010011111111110110
111110221baaaab0011220111022222221022222112bb1a111a10a1112021100212211202221222101221212021200011021021122120022211001121222100222222102221001211111111111111111
110110012a2212222212101222222222220222221101a0a010a11aab12212012222221222110021011222221011100112101100212201112220220221221010010121112111212201100101101111111
110221121b02020202022122022122110201122221babaa111a1111aaaa11111111010111101111001012011121121111011012000210112212021121202222112121211212122010111110111100111
111202110b21212222020222112222121212222112b12aaaa0a0111aa1a11111010010111111101110112111212220212001112120211212200212222222120101111102212122200111101011111111
01aa22011aa1101122222220121122022102012122b11aa0a1a1111aaaa10011010011111101010110111112021202122102000021122112120112220012122222200021011012011101110111110110
10aa121222a1012002212221121222210202110021a11111a1a1111a11010111111011101111101101112200221222112002121101021110202111122212112221100202222220111111111101010101
11ab022222a1212221222202222110212201121221a12110aaa1011a11111101111101111101111111111220001110122222022120212222221022222100122120122011122220010111011111101101
1aabbabaabb1120112012202221022022221212baba221111111011aaaa11111110111111111111110110112221021002201012211110102000021211101022211210111211120111111011111111001
1aabbba02110211222200022222222222202100a2212211111010111aaa10101110110101101111111102221221121220010012201122202222202020111100021021102121022111101011101000101
aaaa12baa10122201022222212211abbbbbbabab0210111111111111a1011111111111111111111011111121212112212120022221102202222111111110111101111111110111101111110111001111
a11b12bab11111222222021221220b02121012212102211111011111a0010110110101111111110111100201121200120221021122000022221111110110101111111111001011111111111110010111
a01abaa2120212021212222212011a22221221120211211111111111a0100100111101111111011111112111211212111002021010021001201111111111011111101111101010111101011110000011
a1002112101022210011021022122b00212121102112100111110111a1111100101101110111011011110020102012210111211100201012122111011010110111101101011111111101111111110111
a1111011100111220220102122120a22021120102112110111101111a1101110101100111111011101102210212011220121101222112221212101011111110101111111101101111111111111110011
a1111111111110112101220120112b20201212112101110111110aaaa1011011101111111110111111110122202212211112122110110102211010111111111111111111100111111101111111110111
00111100110111121202222122202b00101222102110211011100a0101110111111111111111111000111101012122121111121222122110100010101111111110011111111011111010110111101110
10111110110111222212112102110abaaaba12222010200110001a0111111011101000111011110110111200012121220021211112022012002111101111111111110111101110101100111111111010
01111110011111001212211210221121100b12122022111011111a1111111011111100111111110110101112122121001001212202021122221100101011110111110111111110111110111111111101
11110111000111201202021012222011212a12202012111011111aaaaaaaaaaaaaa011111101001101112211020212001001221121222212021110111110101101111111110101111111111111111011
11101111111111121021112112111110020b201220211111111100111111101111a101010111110111112021111112122111122021121101222011111101101011111100000111111111110111100011
11001110111110122101021202222122212b002102121100111111111110111011aaaaaa1110111011111212110122222021201102112021200111110101101110011111011111001111110101100111
