147,117
7,15
106,116
27,77
41,108
63,15
68,67
64,109
142,33
100,16
11011001110101111011101111011110110001101111a1111210021211211111121102211211112101111111101000111110111011111110011100110aa1111100110110101101111111101111011111
01110110110101100111111111111111111111111111a1110020212002221111222221020121211110100122202201210200200110221202212101110a01111111111100110111110110111100011111
11110111100011110011101111111000001101111111a1110022021220221210222121022202012110011001202222200212112220112021022210111a11100111111111111011101011011101011111
11111111111111110111101111111111011111110111a1112220201012211002112022222002202111111112202011221221120012022222022011101a01110111111101111111111110111111110111
11111011110100110111111011011101101111111111a0112220201111200110122212112212221010101201020112021202012102212121211201111aaa11011aaaaaaa111110111101100101011110
01111011111111111110111111100111111011111110a011221112221222111111021121222202001011010112112111000020110202020211101111111aaaaaaa01111a111111011111111011110111
1101110011011111111111111110011111111aaaa001aaa1121220120112221102101101011112211111122020021111022002112011111112221101110101111111aaaa011010101110111111111001
1111011001011111111111010100111000001a00a10111a1111012122101022211112120222221110111022111212221020101021001122200100110101111111111a001111001101111011111001100
1111110011101101111111011011111111111aa0a11011a1101100122222200121212121212221111011100022221210021102112102021122021111111011011111aa11111110001111111111111111
01111111110011101111101110110011010101a1aaaa11a12221210220222212002211122111102111001212112121011101101021211121121011111100111111101a11011111111110111111000101
11111110111100110111110011110111111011a1111aaaa12010010120000220222002111112122111111202210212100001211100121222222011111101111111111a10111aaaaaa101010111011101
11111111101111111111111110110001011110a1111111111111100221211211101121211100121111010020012020222112202102111200110111111111111111101a11111a010aa111101110111110
00101111111111110111111100111100110111a1111111111201110122110202111021122022100101111011121112021122012222211220111211111111111111110a11111a100a1011111011111111
10011001111111111110011110111011011110a1111111111210201221211212120221120121221110011022101021120010100012202210221211111010111101101a11111a111a1101010111111110
101101111111111111111aaaa11111111110aaa1010101012001011222021212211210102121221111111201101112112111110221121122011210111111111111111a11100a111a1111111111111111
111111111111110111101a10a1101101101aa111111111110102000111121112202211122100111111111111112201102102111022111022211111011110011011101aaaaaaa110a010101101100aaaa
110001111111111111111a10a1111011111a11101101111110011101122022121012222122111011011111121201011112121100202110211121101101101101101111111110110a001101aaaaaaa11a
110111111101111111111a11a1110101111a11100110111112210100212021222211100121112210111101012110201101222202011111021011110010110111111011100011111a111111aaaa1aa111
111111110101111aaaaaaa11a0111101110a11111101111111121211000222221121212120211001110112002100001211020101211212210021101110100102222210101220121a222100bb1babaaa1
11111101000110aa01111111aaa10111111a11100111111101110222211222212022112202011021111112022211200111120201021222202221011111110101112112200101121aaba10011020220a1
01111011111aaaa11111111011aaa111111a10010111011110220010222021111100220112001021111011211200111101212122211221222221110011111112121122122202002222b20201002111a0
10011111111a1111010111110111a001101a11110101011010120212100102110002201201112211011112202011211212201211121100201210111110011011112212110110110201b10210200100a0
0110111111aa1111111110011111a1111aaa10111111111111220212122111101110002101202111101112211110122011112122220210102220110111110112221022221111101021bbbab2111bbaa0
1110110111a00111011111111111aaa11a10110111111111000112212202222221102210110101210111010011210111121222221111120012011111110100111202212112212100112121aaabba2111
1111101111a0101011011110111111aaaa111111000011111222211101110012111201211102222111111112111112110011122000122222201001101001111120122212120102121212210221ab1211
1010111111a10110111010110010111111010110110111111002022100201121112122220121121111110120121111012210221211112012210211111011111022121102022010212101020112111210
0001110010a11100111111111110011101010111111011101201102011110111110202102211201111111111202112120122121221202012001210111111111120101111022202222201201010201201
1100011001a01111110110110111111111111110001111102011012012020220022002011111220100010210011221221211212211221211201211110110111022212222020110222202201022221201
1111111111a11111011101011000001101111111110001012121211212022212221021211121122001110001121110221111221220002220002110111011011201200121212112102212200202210001
1110111111a10101011111101111111011111001111111001212212210212211212112002121202011111001101100112210112202222122212210011011111212211102212012110111012210212210
101010101aa11110111101111111101111110101100111101221121110020212001102210010202111111211101210120111102210110110122211011100111111221112210101022012111211012101
101111111a110101011111110111101110111111010111111110011101110111111111101111111111111212201212221110111221200102212211011111111112212022211212011201100112111210
111111001a111011111111111001111011111011011111110011111110111011111111111111010111010011101011101110110111111110111111111110111120101210112101221120222212222000
111111011a011110111111111111101110111101111111110111111101011001111110011011101111111111001011111111111111111111111010100111111202121012122211120022221012110111
011110011a011111111100011101010010001111100101110111101100111110011101111101101111111110111011111001101011111011011101110001111120112102211112010221100112212211
11011aaaaa101111011011111100111111111110111111111111111111111011100111011101111111011101111111111111111111111101110111111111011202222220121222101221111211211011
11111a1011111010010011111111111111011001101110101111101010101101110111111101111111111111110111111010110111111101111100110011110210211010011212122012200210220011
11aa1a0011111000001111110011001111011111001110111101000011111111010010111000011111111001111111011101111110111110101111101001111120101002201110102211220202112110
11aaaa0011110111111111111110100111111111110111110111111111111111010111111111110111011011110111111111110111011110111011111111111112122202020221122212021222201211
11a0111111101101111110111001111111110110110111111101111111101111110111111111011100001111111100111101111011011111111101110111111222112111021100121121212021121211
11a1001011111111111110111110111011110111110011111011001001111111111111101011101111111100111111101111110110110011110111011011110102011210122020020222220122120210
10a1111111110111101011111111111111111101101111101111111111101101111111011111111111111110111111111011101111111110011111111110111101111211120102022222221201121010
11a0110101101111101101101111101101101100111110111111110111111101011111011111010111011111111111111011101111111111111101011011111100112111122111111202220010201211
11a1111111111011010110010111111101110111011111110111110111111011101011111001111011011111110011110111111111111111111011101111111121100211122201011111112012110101
01a1111111111111110101111111011111101110111111111111110001101111011111110111111111111101101101101110111101011111010101111111100120222221112210111222201201011211
a1a1111111110101111110111101111101101111101111110110111111111111011110111111111111111101110111111110101101111101011111101111111221120121121101222120122101011001
aaa1111111110111010111111111101111101111111111110111110101111101111110111111111111111011101101011111110011111110111111111011111222201220111202210112201220112101
1111111111111110101110111111011101111011101111011111101011011111111111011001011000101001111111111111111011111110001001111011100021020012120120102121210110122011
1111111101100011111111011111110100111101101111010111110011111110101011101111011111110111111101111111110101111011110111111111001001221122012121210100021121211101
1011111101111011111010111000111111111111111111101111100100011111111111011110011110011110101111011111111011101111111110111111011111110100101111101111111011111101
1101101110011111111101011111101111111101111111111101010110111010111111111111111111110010111110111110110101111111011110111111111101110011001101111110111110111101
1111111110011110111011111011101111111110111111101101111101101111110111111101110111100111011111111110110111111111111100111111101110011111110111101101111111101110
0001111111011110011011111101111110011111110111111111121102211221122112012111012001211111111111111110101101111101111111111011111111111111111111111111111101111111
1111111011011111010110010011111111111101111111011111101012210221021122112200222110221110001111101110111110011111111111101100111011111110111111101110111111110011
1111111010011111111101110111111111111101111111011111110010210112112120212111120122101100011111111101111010110011101111111011110101111111111111011111101111111111
1110011111101111111111101111101011011111111111110101101211210111211202221220210102120011101001101111101111101111011000010111110111111100111111010001100110011101
0011110110111001111111101111110111101111111011110111100121011222012111112211020012121111111111111111111111011011111011100100011001001111101011101011111101100110
1110111011111101111111000111111110111011001110111111111122200112121022221010202100221001111011111110111111111111111110110111101110111011101110110111111110110001
1110011111101111101101111111011111111111111010011111112211221211122200211212211110011111111111111101010111110111111110100111111101111111101111101011010111111111
1101100111111111111111110011111101001111111111111000121122112111111222022021211121021010011100101011111011111111111011001111111110001110101110111111111111111011
1011111011111101111011111111010111111111111111101011102110021010110221220200210112101101111111101110111111101111111111111111001111110101010101111001100100100111
0111110111101110111111111111111111111110111111010001120020211012011000002210122211201111111111110111110111110010111111101111110111001111101011111011111111011111
0111011011112111101000121201022121122012221111110111001121211210201012122211022121111111111111011111011111000111111111111110011111111010111100111111011111100110
1111111111112102012220202102112212002021202111100101121121222111011212221022211021220111100111111110011111110111111101010111111111111111100111110101111011111111
1111101111111221222000121111111202202012012110011111110021211010202110111012102222221011111110011111110111111100101111001011101111111110011110111110010111110110
1011111100001101121021210122222112000001012101010110102221112022020012211101001100111101101011111111111110111111111111000111111111111111011111011111011111111111
1111111100112121221212112201200101211211212110101111101220201112112202111221112222211111101111111111111111011111111111001100011111111111011111011111111111111111
0011110101002202112222212022112202112222220110111111122122220111222201222012112121020011101001101111111111111111111111111101100111000101110111010011111111111110
1001100111111120110202222122101001211210222111111111111012221021021121011112122102211011011111111111111111110111111100111101111111110111111111110111111011110011
0111111110111122121221010111211121221222211111111111122110111201001220201121010211121101111010101111011011110111111101111101011111011111110111111111111111111111
1010111111110221122012100100212002221121122001111010011021212000022212110122122122211111100111111111111111011111101111110011110101111111110111101111111111111011
1101111001112112102121122101222221202022202101110111111211021202122221221100222111121111111101111111011111101101111011111111101111110000011111111101011110100111
1110111101101021101211112121121222212100112111111011101212121201020111111212200112201110011111101110110111111111111111111111111100000101111110111011111111110111
1001110111111002222102121212012212022022121011111111111201011212121110211021211202011101111111111111100011011111010110111101111011011111011011110110101111111111
1111101110012112111212222112121110021022121111111111112102102011020100110001022001121111110111111011011111010101010111110110110001110111110101101110111101011101
1001111110102211022222111122122212221112111011101111122221101212121112112012110210110101110111111011101111101111111111111101111101111111110111011111101111111111
1111110110112122211122221200222102111122201111011011022012212022221222121011111022200111101111011111111110111111001111111010011101111111110111101011001001111111
1101011101112212120202111111121022100221100111101111121120212112221212112102212000211011111110111111111011111110111111111111111111111111100110111101111101011111
1111101010011211121221001212102110101122120111001111121121221222101111212120211022201111010011010111111001111111110101110111110111011111011110011110011111111111
1111111111112201012211122202122200022212210110111011011222202022212221212211120121011111010011011111110111011111100110111110100111111111111111011101011111111111
1110011100110020212012200110121222011022121100111111101020221222112222121212121201220111111000111101011111100111101110001111111111101110111111111111110111001111
1111011111111010022112200112201122020220222111110111120011112022222020012011201202220111111110111111111001111110101111001111111111110110101111011111011110111111
1010111011111122102112121122011100121210110101101010011012210122121220111222221012111100111011101111111110111011110111111111010111111111100111101101aaaaaa111100
1100010111112221202211102212221101111021211111111101101101111101111010011111111101111101110111111011111111111010111111111111111111111111111111111111a1111a111101
1101010010110122102121111101112121120010121001111011010110111000111101110110110011111111110011101111101101110010111111010001111111011111110111111110a1111a111011
0101101010112120222012000102120011000120121101110111101110111011111111111111110111010110111100111111111001110111111110111111010111111111101110111100a001aa101111
0111100011112201112112112012012201122222122010011111111111011111101111110111111011111111111111111111011111101011111011011110111111101111111011101111a011aa110111
0111000110111102221222111002202121121201112111101110111111100111011111101011111111101111111111011101111010110011011111110101111011101111101111111111a1111aaaaaaa
110110111011121112222112012122102111012222011111110111011001101111110110101110110011010111101011111111100110011111100111111101110111111101101111aaaaa1100111011a
10111011111110112211011022102012221110220210011111111111111111111111011111111111111001111111111010100110111111101111111110011111101101110111111aa11111101111111a
11111111101112101212201122210200120012111121011011011001100011001111101111110101110111111101111111110011111111011111111111111011011111111111111a101111010011110a
11111111110111221121212122201021122101122101111111111110111111111101001110111111110101010111011111111111111110110111111101011111010111111011111aaa11011011101011
1111111111111101022020222001212221212002201110001111011111111011011111011111111100111101010111111110110001110100111110111010110111111111110110011a00110101110111
1111111111011110111110101122200022222201002121011201012210101101110111111111111010111101110111000101110111111111011111101111110101111110111010aa1a11110011011111
110111001111111110111111012221222021202122122101120120202200222111221122112211021111111101001111111111111101111101101011011011111111111111110aaa1a11001111010111
111111110110001111110111110022201111110012121210012202222210011122111100001111211011010111111110111111101111111111000010110110111111101110101a1aaa01110111110011
111011101101111111111110101021220121121112022122202220211111111022111212012110101010101100111011010011011110111000111011111111110111100111001a1aa111111101110011
111110110010011111011111110211202011222221121211202022222221221211222221111210201010000011101111111001111011111110111111110110110111111111111a111111111011111010
111111011111001111111111101111221211111120111012112202122212212101122111121211110111111010111111010111101110110111111011111111011110010011110a111100011111111111
101111111011111111110111010110211200212220021010102222201220011210210100211120211111111111111011111101100101010111011010011110111110111111110a101101111001111101
111101101111110011011110111002002022120112121211122202222112122121022222222220101111100111101011110111011111111101110001111111111111111001100a111111111111111111
100011110011111011110101101010222101222111021000022200200210122211220112112210211111111011111212222221220101211101022122220101010000111111aaaa011101101011110101
101110111111111101111111111222101212212102121101122011222211212212121202112021120011111111121111011012211121112112200221101101011111111000a010111111111110001011
01010111111111111101101aaaba12221211222220002221122212220121121221221222000121111111111011100012122012110021122112211222201001111111011111a111111111110011111010
11101111101111011111111a111b12120011111122212212200122220122112212211201021002111111001111020221010112210020120002011102210101111110111aaaa111111101aa1011111111
11111011111111100111101a110a01120011112221121222022222201211212110111020121110011111111110001121221111102220220000111202121111111111100a1101111aaaaaaa0101111101
11111111111010111110111a111a20102112112101121121022212021221020111201202102012011111100100020221010010220121120220012000110111111101111aaa11111aaa110a1111111111
11111111111101111101110a101abaab112111021101121222200122020022200122021120222000111110111110102220111020211210221120212221111111011111101aa111101a111a1110111111
0111111101111110110011aa1021001a2211011220121221022222222111120111111211101112210011101111101002022010212221121221001102121011110000100111aaaaa11a111a0101011111
1010111111111110111110a11110202a02221bbaaa1202112202122122201112011222210222220111111000111222222011122121100211122212012110100111111111011111aaaa111a1011111111
1110011101111011111010a11121aaab22112a112a20202101222010112211021111121112010220110011111102221222122112120111210122210112010011101011110101111110111a1111110111
0101101111011111111110a11112a10122121a011a0bba011222202bb112212200110121121120111110111011111112111211102221221110120121001111101010101110010aa110111a0101111111
0111110111011111111111aaa101a12102121b211baa0a12bbababbba111120212010102210211111001111111001212111200111201111122112101201011011101001111011aaaaaaaaa1111011111
111111111101001101111011a112a11211122b1112000bb0b2221212a112221020211111120102021111111011120021210201211102211122210211011111111110101111110a111111000011001011
111111111110111111111111a110b12101121ba1211011b0a2222222b122112202222001201222121101110101110212221110112022221010101221101111111111100111111a111101111110110111
111111111111001011110011a022a022112210a1112201bab2222222b201212011222220201012121111111101121121210222212212111122011101111111111101101101000aaa1111001101101110
111111111111101011110011aa12a21222bbb2a21211121000121200a11221010002020202012110100110011110122120002110120122122120122211111011011100111111100a1110110110110011
1111011010111111011011101a12aaabaab0a1ba0221221222220202a21122020120110111111010111100101112220000110022122022002102122212011111111101111111111a0111110001111111
111111011001001111101aaaaa12ab122aa1aaaa1102102120121000b22121111212001222020211100111111111212112211121211010012011121210111101110111110111001a1111010111111111
1111111111111111101aaa111102001220121111222211210110222ba01222111222111011212122101100110102100120012200211210210021111201111110111111001101011a1111111111111111
