13,110
13,8
117,86
112,93
66,2
67,50
99,75
120,76
108,86
138,16
aaaaaaaa1111110101000011111100aaa110111001111111111211aaa2211010021021120120222212011101110111000111101110110111111111111101100110101111010111011111111111110110
a100011a1000111110101001101111a1100011001111111111102220a2101121122220022021101211111111111110111111011011111111101011101101111211011122121222221210212121111111
a111100aaa111111111101110111aaa1111111111101111111110221a1220000212101212212122010011111011111011011101111111111111110111102102211121202121201101212221122001101
a11101111a011111101110110111aaaa011111011110110110112222a2221121110102112121212100110011110100111001010111101111110111110112221101111121221000220211112222111100
100101111aa11101111111111010111a111100111111111101122120b1111201122201021222110210111100010010110111001100110011111111100110111211120201121212111212122210111111
0111111101a11111111110111111111a111111111111111011122212a0111221212022011201121122001111011111011111111110111111111111111102112212122221100111121102120020101100
11101010aaa11110110100100111010a011000111001101111110aaba2101121221102102211000122101111111110110110101111111110111010011112001122012122121222021122211101111110
11111111a1111001111101111111010aaaaaa1001110011011110b1110211201120012212121222220111110111011011111101111111101011111111112012201121111221122212112122111111110
11aaaaaaa11111110111111101111110aa01a1111111011011121a2210211001122220212221211210011110110011111011101111110111011111111102201211221221011202111010210010011111
11a11011110111011111111011111101aaaaa10011011111aaabaa1011100121102221111122221111111111011111111100111111111110111111101111211220011010002211120102112201111111
01a11111111111111110101011111101a010111111111111aaaabb2201212111210121221221002121111111101110111110111101111111111111101010011121211211212020222022102022011111
aaa11110111010111001110101111111a011110101111110aa1aaa2121022202221211211021210220011111011111110111101111111011110110111111111110220002102212201212210222111111
a1011111111111101101010110011111a111101100111101011bab1212002100111001212112220222110101101110110110111011110010111101111111111212211022222022112211121002100111
a1111111101010111111110111110111a111010110111111100bbb2201120101211001122111211111011111111111001111111010111111110111011100002012210011021012200122222112011001
a1111111111111010111010101011001aaaaaaaaaaaa0111111a211222211212202112102122002110100111101111001110101101111111001111010111220202211221100121000222222112111110
a011111101111111111111010101111111111110110aaa01101b111222201111212221222112000212111100110111111101101110101111111010011110201212121122111221221022112212110110
a111111011111111111111111011111111101101101aaa11110a220002102122122102212202221222110111111111111001101111001010101111100110121212211211121122222201212221110111
a11111111100110111111110101000111111110011110a11011a221101222200210200222120021122011111111101101111111111101111110111000012121200112001222222121210122212111011
aa1100011110100111111011101110111111111011111aaaaaaa001111111111111111111011111011010100100111111111111110011111111011101110212221121121212111212020120111111111
1a11000111101101101110101101101111111111101111111101111111101011101110111111110111111111011010111101111011001100111111111012121222212222121122021211110112111111
1a11011111111111001111110010111011111110111011011111011111111001101111111011101011111000101011100101110010111111111011111111210212022111122211201011122101101111
1aaaaaaa11111011110111001110101111111011111111111110000101101101111111110111011111110101011111111111111111101110111111111102200012222110012222222102122100111011
1101111aaaaa0111111111111011111011111111101111111111010011111110111110101111010101111101111011101111101011110010011111110011202122212012222202022001202112111001
11110100110a1111111101111111010100111111011011111111101111111111101111111111111111111010010111011111111111111101111111011112112102101102211112221101022021111011
11011111110a1011111010111110111011011111011110111101101111110101111111111111100111100111101111111101110101110111011111111112102211002211111002211021212201111111
11011011001a1111011010111110011110111010011111011010110111111101110100110101111111111011011110011111110110111111111101111002102111220221111211021202222221110011
a1aa1101110a1100110101101111111111111111111111101111110111111101110111111111111101111110111110111101111111010111011001101112111002210120212121021112201221011111
a1aaaa10111a0101100111011011001110101111111001100111110111101111011111011110111111101110111101110111111111111101111100111110211222220001120201021201110211111111
aaa11a11111a1111111110111111111111111111110100101111011111101110111101111110010110011111111001110011111111111111111111101111212121012202120112110011022110111101
0111aa10011aa111101011111111101111111100110101110110111011111111111111111101111110111011010111110111111101101111110011011111111102221222221012120102011022101110
1110a1111110a111111111111010110111101011111101111101101100111111111111001100011010110011100011110111101101111010011010110010012222022102222111200212122212101011
1110aa111111a011111111111111111111011110111111101100011101111001111110111011110110111100110011111101100111011001111001111110101010100022222120212101112100110111
11111a111111a001111111101111111110111011011111101111111110111010110011111100111111111101110101111111111111111111111011011111111111010101011101001111011101110011
11011a110111a011101001001111100111111011111111111101111011111001111101101111111101111111110011110101111111011001111110011010111001011110111111110111111111111110
01111aa011aaa101111111111111111111111111001011110111111111100111010011110111111011101111001111111111111100111111111110111111111111101111011111111101111011111010
111011a1aaa10110111111011110111111111011110101110101020211111210011112101120111102111110110111011110111011000011011111101110101001011111101010111111011111111101
111000aaa1111111101110010111011001110101111011101011211111120211220112202200221211200111101111111111010111111110110101111101111111111001101111011111111111111011
1111111111110110111111110001111011011111111111111011111112111121112112210211211021211111111010111111110111001011111111100110101011101110011111111111111101101111
1011000101010111111111011101111111111111111111011101120012221001110221222202112002011110110110111111110111110011111001111111111110111111100111011111111111110100
1110101101011110111011101111010111111111111111111111022011121212221221221112102121211111100111110101011111111101111111111111111011111110011011111011111101101111
1111011111111001101011110111101011011011111111110111221122021111022201211111221200011011111111111110111111111110011110111111111111111111100111111111101111111011
1111101111111111101011111111110110111010110110111011211211111222101222012121211021011100111110110110101101111110011011111101101110111111111101101111101011110110
1011010110111110111101011100111011111101110111110000222020122220101102000010020122011111101111111111111101011111001011111111011100101011111111101011111111111111
1111111111111011111111010100111111111110101111111001221211102121001222221120012011011110000111010010111111110101111001111111110111010110111111111011011111111010
1111101111111110110011111111100111111110111111111111110210101011121211021221122201211111101011011101111110111101111110110101111111111111011111101111001011110011
1110101110111011111110011110111111111011111101111101101121211222200021212212211221211111111110111110111110111101111001111011101111111111100111101101001110111011
1011111001111111111111110111111111111111100111110100122212001120221212012021012212111010111110111011111111111111011011101110111110111111111101111111111111010101
1111101011011111011011101111110111111011111111011011011110211111210211221020010110201111111111111110101110111111110111111011101110110111111101111111111111101011
0101111111011111111111101111111111111101111111110101121111220110211212211121121121211101111011111010111101101110111111011110111001110111111110001110110110001111
1011111111101111111111100011111111111100101101111100121112221112021102122210021122100111111111110011111011110111011111000011110110111111111111111111111111111010
1110111110111111111111111111011011011100111111111101121121201201222211111021111020211111001111101110001111111111110111101111111110111111101111110111111111111101
1111011111111111111110101111101011111111111111111110102021222012021120002121021111211011111111111111101111010101010111111110111111011011111111001111111111001111
11011111111111111111101001111111111111111101101111101111112101200210012012122221202110100111111111111011011111111111111011111111110111111111aaaa1011111111111110
11111011111101111010111100111111111111111111111101110011201020111112222121011221022111101111111011111110011101010011011100110010111111001010a11a1111111111111011
11111111101101100110111111101111011111101101011111102012102212111212220020212122212111011110101111101111011111111011101111111111101111111101a10a110111110aaaaaaa
11111110101111111111111111101111101111111011111111112110211211222220211122202211221101111111101111101111010111111100111111111111011011011111aaaa111110111a111111
11111101011101111111011111111111011110111011011101011202012122100000012020222222202111111111110111111011010111111111111011111111111110111aaaaaaa111100111a111111
10111110111001111111111101110111111111111111110111111012110202011101221221211012201111111111111110111111101011111111111110110111111111100a111aaa111111110a111101
10111111111110111111101111111111001100111000110111112201200011210011121221121121112111011011111011110011111111111111111111111111111111011aaaaaaa101101111a010111
1110111111111010011110101111111111111111101101101111111111201212111212211122222120011111110111111001011001111111100011011101111011101111011011aa111011111aa01101
1010111111011111100101001010111100101111001011001111221121222220010022122220111012212022221220202120122121012112121101110011110011111111110111aa1111111101aa1101
0111111111111011011110111111111110111111100111111101221221112121212111201112201122212111200202010211001101220011202202121021001112202020111111aaaaaaaaaaaaaa1111
1100110110111000111110111110111111010011111101111111210111111200001121110222212221011022021222012222012120021212121211112221222220021122111110a11000011001010110
1111011101111111111011111011111101111111011001110011202121020221110012021210000201211102101020221102111112222221011112002222010121012011010111a11111111101101010
0110111111111110101111111011110011011111110110011111121122111112012111112210220122100111022022100020122120012022210220002120102111221221100010a10101110111111101
1011000111111110111111111011101111111111111110111110212021102001102012112110200121211012101112212211201102221200201201222101222122111200110111a111aaaaaa01111110
1111111111100110100111111101111110111100111111111111111011111111011011011011101011011000102212011012001101021121222022220201221221121112111111a111a1111a01010111
1111101111011101100111101111111011111101111101111111111111110010111110111011110011112211121110221222211112202222222120210102201211102122111111aaaaa0111a10111111
1111011110111111100111111111101110011001111101111100011011110111110101111111011110111012212220112002122202011001220020001211121211221021011110011111111a10010110
1011111110111011111111111110111111111111011011101010111010011111101111110111110010010211222211222001101222022122222111002121111122212212111111011111111a11110011
1111111101101011111101111000010011000011011110111100111111111110111111111111111111110112121122120101012211020022222221112022202022222111011010101101111a11000111
1011111111101111110011111111101111111101011001101111100111110011011111111111010111110122222222222122210212000222222222120222001111022110011111111110111a10101011
1111111001101010100111111111110010011000111111010110111111101110110101100111011101111101221120012022222222222222202212021222212222222110011010111111111a1111110a
1001101011111101101101010111101111111110101111111110011111111111110111011111101111112210111002201021222222222222222222220210122202222010110111111110111aaa01101a
111001111111110011101111101110011111011011111011110110111101111111111101111111111111222121020212222222122220222002200222102200000220221011101111111111111aaaaaaa
11111101011111111000111011111111110101111110111111111110111101111111111101010101111111012211121022021222122021222220220221220002021120011111011111111110aaa01101
11110011110010010110111111111000100111111111110101111010011110101001101001011011111102220110002001200220202222222222212011021202212010121110111011110011aaa11110
1111111101011110111011110111000111111111111001101101111111111111111110010111110011011002002212122222220202022222222220021012222212220121111111111111110111111110
1111110110100110100101101011100111111111111011111011111101111001111100011011111110111121120200220100112222222222222220022222202101222101111011111110101110111110
1111111111100111100111111110101111111101011100111101011111111111101111111111011111000221121122222222222222202222222002202220022201012210111101011111110101101111
1111111111111111100111111011011111111101110011111110111111011111111111011111111111111221221022020221201022222202022022022222212222212221100111111111101101111111
1111111111111011111111111111111101111011101111111110101111101111111011111101111110012101212012212020220220222020220220220222222220222222111011111100111111111011
1111111111111110110110101101111111101111011100111011011011111011011111011010100111101002111112022012010212202222022222220200202222121122111111011111111001010001
1101011111011010111111111110010110110101111110111111110110111111011011101101111111112102012022222222222222202200212022222021211210202201100111111111100111110111
1001111110111111011001110011111001110111101001111001110110110011111110111110111111011221200120222202200222222222222222222020022210222220011111111000111110111101
1011110111111100011111011011111111110011001011011111111111100101101110111101010101111201110222102221210222222022202200222200220220021220101111111110111101101111
1001111111101110011111100110011101011110010100111111111110101111111110101111111111111100022212202200212221222222222220222022212202022100011101111111110111111100
1111101110010111111010011111111111110111110011110101111111111111100101011011010111112202120122000002221120222022222222200222212212202010011111111111101110111111
1111111111100111111111111111111111101111110111111101011101111110110111110111111110111212120212112221222222012222222212220222222002202122110111101101111001101101
1111111101101110001011111111011110011110110011111000111111111111111101111101111111110221220012221022202222202020200222122222120211002212111110101111110101101111
1011101011011111011111111101111011110111111110111111111110010111111110011111111111112110212121002221222222222022222020002202222022202202111101011001101111001111
1011111111111011111111001101101111001111011111010011101101110011111111101011111011111011011112212220120020222022202222222222220221021211111011111111010100110110
0111111101101101100100111011011010111011101111111101011011111110111111101001111111101001011111002220222222222222222222121112210211210111111110111111111110111111
1111111111111011101111111011111111100010111111111011110111111111100101111111111110110111111111121112202222222222220022202202210021222111011011111001101111111011
1110101111110111111111111111011001011111110101011111111110100011110111011110110111110111111111212001222222102200002221220220122001022010111111010110111000111111
1111111000110111111010111111010110110011101011111110111110011111110110111111011101011101111002202122222222222221220200012000021220202110101111111101001110111101
1110110111111111001100111111111011110111011011011110010111110111111111111111111011111111110111020221222202010220222222020202202122111111100111111101011110110101
11011110111100111111011011111111011101101101111001101110111011111111110111111010011aaa11011110001112212211022221020222022002220001220111111111011111110111111111
11110111001111011111101100110111111101111111111111111101010111011011111111110111111a1a1aaaaaa0222022220202212212212201122202222211112101111101011101100011111011
11111111011111111101101110111111100101111010111110001101000111100111011111111101110a1aaa1100a2102022212220202220022202222221122110220001111011111011110111011111
11111111110110111111110111110101111111111111011101111110111111110011001000011011101a1111111aa1210212222122222221220222210221012212002111101111101011111011111101
01111100001111111111110111111110111100111111111111000111111011101111110011111101011a1011101a11201200022212202222222202220001202221121111111111111101011111111101
11101111101111110110110011110011111111101011111111101111101110111111110101100111aaaa0101101a11111111011222211121212122121211200211111011111111110111111110111111
11111111111111111110100101010111111111111111111101111101111111110001110101111101a0011110aaaa11001121011122200021221110111120210011111111101010111110101111111111
1111111111101101111110011111111111110001101010111101011111011001000011101101111aa1111111a11110011112211102112221202122212121022101110101111111101101111111111110
1001111101111111111011111010111101001101110101101111001111101110011110101011111aaaa11110aa0101111100011121110212021121101012111110111000111110111011101110101110
0111110001011011101111111111111111111011111110011111011111111011011111101110111101a010111a1111111221211110220122210111222121011211111011110111010111001101111111
1010010111011011101111111111111111111111111001011011111111111111100111101111111110a011111a1001011111101122120222020111201200120211111111111111101110111111111010
111001111111011111110110111011110111101111111100011111011011111111010011111110111aa101111aaa10110222221110122202000202121112222211111001111111010111111111110111
111000111111011111100111101111111111111111111100110111111111011111111110111111111a011101110a11101101111111111111111101011101101111010100101111110110010110111101
1110001001101101110111101111011111111111100111011110101110001111110011111111011aaa111111111a11aa1111111111011111111110101111111111111110110110100111111001110010
0111101101011111110011101101011011011111111111111111101010110101011101101101111a11101110111aaaaa1111011101110110111011001111001001001111110110110101111110111011
1101111111111111100100111110111111101011111101111111011111111111101110111111110a111001111011011a0010010111111111101111011101111101111100111111111001111101110111
0101110111111111111101111011101001110000111011011111101111111101111111111111111a11111110111aaaaa1011111101111111111011011111111011011111011111111101111111111111
1111111011110111101011111111101111111111111011011111111111101110010110111101111a10001101111a11101011101010101111110111111111111111111110101101111101111011111111
101011111111011110010010111111010011111101011101111101111101111101001111011aaaaaaa111101101a11111111111101011110011110111111011111101111111100110111011111110111
111101111111111111111010111101111111111011011010011101111111110111011111111a01aaaa101101110a11111111101111111111011110110011111110111111011111111010100111110011
111110111111111101111111011111101111011011111001111011010111100111111001101a100010011111111a11110111011011111011111111111111111111111011111001111110101111111001
01111010101110011101110111111111101100100110111010110111111111010110111111aa110111111101111a11111111111111111110111101111111111111100100111111110110111111010111
10111110101110101111011101111111111101101111110101111111010111011111011111aaa11111111110111aaaaaaa01101111111011110111011100011111000101111111100111100111111111
