141,8
2,8
3,37
94,103
96,18
49,67
41,46
63,93
114,68
41,104
11111111a11110111110010111111111111101111111110101111111101110111111111111101111111111111011111111111011111111111111111011110011111110aaa11101011111100101111111
11100100a1101011001110011111111111111111110101110011111111111011111111111110010111101110101111011110111111111111101001101101101111111110a10011111101110110011101
11111110a1111111111111111110111111100110101111011101111111111110001101010111111111011111111111110111110011101111111101101111110101111010a11111111011010111111111
11111010a1111101101111001111111010101111111111011110111101011111111011111111111112100110212111220010111121221221111110111011110111111111a11111101101111110110111
00111111a011101111111001111111011111111111110111011011111111111111100111011001101111012110010011201100101122210210110101011111101111aaaaa00111110111010111101111
11111111a101111101001110011010111111010111000111111100111111111111110101100010111011011111120122101011111121011201111110110101011111a111111110111101110111101111
11111101a0101111111111111000011111110110111111110011111111111110111010111101110101220221112001120220200012110002101111111111101110aaa001111111110111111110101111
11111111a011101111111011111101111111101001111111111111111111110111110011101011111112111012121222022211212222101011111110011111101aa10011110101111111111111111111
11110111a110111110011011111111110111111101011101110111101101111111110011111110101000222012202201122222121220121001111111111111111aaaaa11101111101111111011011101
11011111a1111011110111111011101111111111011011111111111111110111101111111111111112222110111122111110120010111011111110111111101111010a11011aaa101110001101111111
a01111aaa1111011110111101110100101111010101111100111111011101110011110101110100110121111121102112201112111002210111011111001011110101a11111a1a111111111110110110
a10111a110111111111111001111111101100111011000111111011111111101100111001001110110110212101111112211121212200221100111101101010111111aaaaaaa1a111111111011110111
a11111a11001011111011111110111111111110010101110111111111111111111111101111001010101101202111121212021221121120101111110111110111110111110101a111111111111111111
a11001a11010111101111011111110011011111111101001110111101001101111111111010110111020221211221002211221012121011211111111001011111101111100101aa01111111110111110
a11110a1100111111101111111110111111011011100111111111111111111101101111001111011002120200212110201022201221112201111111111111111111111111011aaa01101011111111111
a11110a1101111010111011101011111110111110111011011011101111111110011110111111101112022220122101010100220220201210101111011010011001110101101a0111101101111111111
a10111a1110111111111110010100101111111111011111011111010101111111111101111111111101212012110201112100201212102201111101111111111011010101001a0111111011111011111
a10011a0110011111111111100001111111101101111111011110001111110111110111111111111020212111011221201022011212021221011110011011001101111111111a10110110111aa111101
a10111a1011111010110111010111111011111111110011100011110110111111101111101101110012121012111112202020021120022221111111111111110111111111111aa1111111111aa1aaa11
a01111a11111111111001101111111111101011101111110111101111111100111011101101100111020101120021012220121201221212111111111101111111101011111111a010111111aaaaa1a10
a01111a01111111111011111011100110111011101111111111111101111101101111110001101111111101101120012212120111122121201111111101011001111111010011aaa1011111a11aa0a11
aa1111a1001111011111110101111110011111110101111011111111001110111111111111100011121111220021110210122002010210221110111111111101101111011111100a11100aaa11aa1110
1a1222aaa12012122201010111111011001111111111101011110111110111111111001111011111112222211102221221222122101112121111101111111010111111110100110a00100a1111aa1a11
2a122111b11111021011101111011011111011101101100011111101111111111111111101100111102210210120021112221200220102111111101101111111111111001111111aaa011aa111101a11
0b00bbabb1120211221011111011111111010111101111011101110111001111110101100111111110122201120220102111110121012210111110111111111011111111100111101aaaa1a101111a11
1a10a21aabbb2111221110111111100111110111110101111101001111110111111111111101111110010102112212000212222211112212101011111111111110100110111011111110aaa011101aa1
2b02a01bab1a11012000111111111111100111111011101011110111111011101111101111111010111221221211220121111002112111101110001010111101111111111011011111111111111111aa
2a11abb12a0bbb10222111011111111010101011011011111111111111111111011101011110111011100120212110122221201000011021111111011101111111100111001110111110111011111001
1b2221baab012a10221110111100111110011111000101111110111101111010111110111111110112122200102120201220110211202122111111001010100111111101011101111110111111110111
aa2221ab11210a22122111111111101111001111011111111011100110101101111101111110111110112002121122012011021100221220110111011101111110111011110111110111111101111001
a22200aa12011b11211111111101111111111101011111111001101111111101111111110001111100222222111200022012002011211012111101111001111000111111001111011011101111101110
baa210aa00221bbaaaa100100121112111110021210200111202111111111111110111111101111111222111111221020220101201011112111010110111111011010111111011111101001011111011
00b221100122111220a110111111220211201212112110220021112011111111111101011100111112120120111220212012200222111221101111101111111111111011010111111110111011010101
20a010212112122aaba111101112111102201211220011022212122021101010111111101011111101000002122201102120112220112200111111111110101110001111111011011111101111111111
02a202100210010bb12001011120121222212222221111102010012121101010011001111101111111011111111111111101111111011100111011101101011111111111011101111111111000111111
22a11211200100abb10111111101220221110021212220212111221211111111111110111111111110111111110111100100110110101111001100101011011101111111111111011111111101111110
21b02101200222a2210111001011111211210220111101212211112110111100111110110010111101111101011101111011011011101011110111101111110000111111100101110111011111111111
baa10210120101a0211011111110122220212112120111212211022021110111111010110011001101111111111111101011111111010111011011111011111101111111101001111101011110011010
bbaab012021aaab0212110101111111211112012212121221010120121100110111101111100111111111111101011111111100111110111011111111111111111101111110011101100111110111110
2222bbbbbbab1112022110100101211210112110201001212211012111111111111101111111110111111111110101110110110111111111111110110111111111111111010111111101101001111101
1221121122010222012110111021012122001022221220212211102111110111110111111110011011110101111111111101111110111101001011110011010100011111110001011111111100101101
1012121111111120000111110110101202121110021111101112211001110010111111111111111110101101110100011111111111111111111111100111011111111111110110111110110110110011
0122222220201111202010101012020221210122210202022001112121111111111100011111010101010111111111110111111111111111011111111111111111111101100000111101111110111111
0110121100012211100100110122100122101020220211012022201210011111111110111111111110110111101100111011110011011010111101001111101111101111111110100110110110110111
2212202102122011022111111121002220211112102200101012020221111111110110000110110110111110111111101101011111111111111111101111101110110111111110000101111111111111
0012212022002120220011101101212221102201200210211011102211111111111010111111010110101111011111101111111111111111011011111011111001011111010110110011111111011011
2012222002022211121110111122221220202012101220022121221021110111011111111111011011100111111111001111111111111011010111111111011110001110011011111110101011111111
2210111120221211021111110121211100211211020111112022122101111111010111111111101110111110010111111111110111101111110011111111111111111111010111111101101011111101
2211120122201112021101011111112110221002212221221112221221111111011001111111111111101100111011101111111111110111110111011111101011111111111110111110111100111011
1111120222112210212011010021201120121112112122122212100211110111111111011110011011011110110101111101001110010111011101100111101110111011101110111111111111101111
0211122201122222210101101122212200021011222210222212222121110111111111111110010011101101101111001011111111010110110111111111111101101111111111111111011011011011
0012011121222021110001110101221111220011101020111222211200111111110111110110111100111111111111111110111011111111111011111011111110011111011110011111100100110011
1121211122211102111111111120110221002211222022200222200111211211210111111111111011111101111111011111001111011110101100111111011111100110111100011111111111101110
1011011110110111011111111110112210202100222221022201220112002220110110010101010110111011110101111111210101120022122012120111010110010001111101110010110111111111
1101111111011111011111111101211111122100222212202122201102012022011111011111111111101110111101101112012100121210022011122222121012111111111011111110111aaaaa1101
1111110111111111000101111112111221222022112222221201122221102100111110010101010011111011101111001111102222111220111021012122121121011111101111111011101a111a1110
1111111001111100111101101110201222022221202202122122121222021122210100111111011111111101111111011112212021120221201212122211111011111011111111111111111a111a1101
1011111111110010011111110102201121021221221222222221221010200220110111111111111111111111110101101110111202010011201102011221101111010101110111111111111a110a1011
1111111111101111111111110020110122111020221222022222222202211120211011111110010111111011111011111112021021120211112202202101122211110011111101110111010a111aaaaa
11111001011111110111111111201201002222201121122212202022212001221111111100110011011111111011101111121122022121100121100111122222111111111111100111aaaaaa1101101a
10101110110111101101111111001110111011112222200022122212221112210010101111011111010111111010011010021022212100121222101221212002011111111111110011a101101111110a
00110011111111001100111111121022122212212222101222220222122120211111111111111111011111110111001111010121112001121110222100222100221111111111101111aa11101111110a
110110101101101011111111110111101110210011022121211110120200211211111011001111111011111101101111110100100122012012221021220110220201011110111111111a011110111111
011110011011111111001111001101111112020101011212020111112210212021001101111111111111111111111100111112011022122122012022221100011211111110111111111a010101111111
111110111110101110011100101101110111222120101121122120101112101101111011111110111111011011110111110222112222212122211100112212110011111101111111111a110101011010
111011111111001011110110111011111022201202111212122110122120112121111111100111011001011100111111011022022112011110221111101220011111111111111111011a011101110110
011111100001111010100111111110110111121210211221111021122212020111011110110111110111111101111011111112121221212112101222112110110211111011111111011a111111011100
111111111111111111111111111110111000101102012122111222212112100110011101011111111111111111110101111212012022122221222201112011221010011111101110aaaa011110101101
110111011101011111111110111010111120210222110212121210122212222101011111010111011111111110111111111122211111212020101210211112010101111111111111a111111111111111
110111111111111110111111110111011101212120220220010122222011122111100111111101011001001101111011101111121102202021100122012000111101011111111010aaaaa11111010111
01111101101110111101111100110111101120122221111201011121221102111111101111101110111011110111111101112112122012111201201221212202120001111101111aaaaaa11011111001
11111111111111011111111101101101112102111011112121221202021122011110111101111111101011111110111110120111111212222020122222222122201111001011111a1101110111111101
11111101101101101111111111111111111212211012120210100012111121220111111101110111111111111111011101122021000012220210222222022012001111101011110aaa10011111111111
1101111011110111111100110111110101222222120010011122021021210211211111011010111011111110111111101111212102222112122102111102121102100111101111110a11111101000111
1111101011111111001011111011110111100121221102001211022111121111011111111111111011001110111100001111021012121102020210112100001102010111011111011a11111100011111
1111011111101100111111110011110111121022212210101112100110121010110011111110111001111111110110111010021121211102121211020221121211011110101011001a11101011111111
1111111011101111011111100010010111011121120122211221002212111212111111111100111011111011001110111101121202102121211222122222001021111110001111111a11011101011110
1111101111110110111011111001001110122111111221212011222111011101011111010101111011111111111001101111121122110200010001221112012212111111111111111a11111111010111
1111111111101111010111110111110011212202121112210222022122002211022021212200222110110111011111111112222012210102020112211100001101111111110111111a11001111101111
0101111111111111111101110111110111211102212212222102002212022202120222112222211111110111111111111110222201112220211202111111021101100110111110011a11111111010011
1111010011011001111111111111111011220211121101122221222022002012201101112211221101111011111111111101012012121021222001112222002101010111111101111aa1100001000110
11111111101101111110111111010011100012122020212122220212002222202211201200220111111111101011111110002101121120101122220112221212110111111111111111a1111111110011
11111101101111111111101111101101010210120221222100221022222222222200212122112111111110010111010011012011012222121201022102122022021101111011011111a0101111111111
11111010110111110111111110111000111111111111111001220221122200122011121220121221011110100100111111121211002112110021022122020221221111100110011111a1101111011111
10111111110110101111011011011101001111111110111102212021102021221201122122001121110011111011111111011111111111101111101111001111110101111111111101a1111111001111
111011011110001111101011111011101110111101111001221012022201002220122121121221111111101101111101101111011111011111001111010101011111111111010111aaa1011110111101
111111111111111011011011011111100111111000001101201102221112121202100120201212110111111111101011100111111111011111111111111010101101101001110111a101110001111111
10111111111111110111011111111011111111111111110111022212120012121121121101100211010111011101111111110111111011111011111110111111100111001011101aa110011111110011
11111101111011101111111111011111111111110111111121112202222222120121001111212121102101020111202011211202211220111101111101111111111011100110111a1111111111011101
111010010111110111111111112222020122121111122022112210222120110112112011212010121010122001212110111212012120101010111010111110111101110001aaaaaaa111101101100100
11010111111010111101101111122111212221122112200121122022200222012000020011211121002122110212111201222012222110111111111011101111011111aaaaa111a1a111111111011111
01101111110111110011111110122112111022011220111220202000221222102221112012120101221100102210202120221200011211111011111101111101111111a0111011a1a011011111101011
11010101111111111101101110222102021221210111211220220112122122222222211121110110222002012122102011021212201202111111101101111111111111a0101111aaa101111110111111
11110111111011011111111111012112110121112121220222220222221201212212200010211112100020222211101021100200002112111011111110101010111111aa111111110111110110111101
0111101111101101001111101110211112121122222010222120201121221110112002202122022aa210020112221221102201112221221111111011111101111100111a111101111111111001001111
0100111110111011011101110121202221012222010112112220212212210122111221111210000ab210120112112022021001012102221110101101110110101011011a111111101111111101111111
111111110110111101111111112201212102021221102122221220222201202220122220010220bbaabbaaaaa1211212021201211011201111111011111111111111111aaaa001011001111100111110
01111111110011100111110111112112211212112221110120210022212012102111122221012ba011220001b1222011222120210211111000111101011100111011111011a110010111011111111111
101111111111011101110111112221011111102221211211122212222122101212110021122aba2100121021b1222111101022222221200111111111111111111101101101a111111111010111111111
101111111101011111111110111020122101201112210211220022222221102012220210121a120221121222b1012012120221120101121111111001111111111111011011a111110101101101110111
111101111111101011111110010102222021100221212210212220222220110200112112021a20202211112bb1112212201010112211220100011101101111111101101111a111111111111110111111
011111111110111111111111011212202022101221202211222212120201012011222200100a21221021022a00110010221201112112020011111101100101101111110111aaa1111111111111011111
101111011111011011111100111122222102211112120211220211021022211102122221021a01221212012baa00012001112010000120100100001101101110101011111010a0101111101010111111
111111101101111101101111011210120021112210202011222200222201120122112222221bbb12120212012b01221212210210211112101111100111111111111110111001a1111011011010101101
11011110111111111111011111212120101122101012121122022020010122101120121111021a11201221120ba2110210112221111111111101111111110110101111110111a1001111111111111111
11111111011101100101111111102202121121121112221122222222202211121020101122021a010201022122aa112112200111212212110011101110111011111100111110a1111111111101111111
11111111110000100111110111101210201001022122221222200221102220102122102210102b01121211122bab112201112222201220100111111011111111011011111111a1101111101111111111
10111111111111011100111010112012011002202002012212212222222221111120110122221aa1211121221a22022211210221200201001111111110101111111101111110a1110011010110111111
101111111011111111011111110212221111211220111111211220111100200211220111212102b0222101110b12022022211210210121011111011111001100111101111111a0101110111101111111
11110111011111111011101111122001000022221220010011202221201101001101111110aaaaa111112012ab12020211221201112120110011111101110111111110111111aa111011111001111110
00101111110101111111110111200012120222120001110221122120211011011111111111a1111212211210b2111020002101110212211111100111111101101000111110010aa11101111010111111
0111111111111101011001111011021020112121110211212212112111101111111100111aa0011211122011b12212202220202021022211101101001011111110111111011111a11111111111111111
1101111011111111011111111111110111111101121102211101221110011101011111111a11101211210012a21122122010201122212211111110111111111111111110111111a101aa11aa11001111
1111101110101011111110101111220211112022222000122002201100011111101111010a11111121111020b11122112011221011222111111111001111111100111111010101aaaaaa11aa1aaaaaa0
1111010110111111111111001021121221202022112102112222221011111101111111111a10011212221baba2220102112112112012010111010101011111111111111111010111111a11aaaa1010a1
110110110010111111100101112122020011112121221221101212120010aaaa111100101a10111201111a2211012121112201222102201101111111111011100111001111111111111a10a1111001aa
111111011111011111100111002202212121111112012012112122010111a11aaaaaaaaaaa11100212220ba201100111201010202110221111001101011111111110111111101110011aaaa111111111
011111111111011111011000110121002011012221122221220122200110a1110110111111111110222120aababa12220202011021120201111111111111111111101110101111011111011111110011
111111101111101101010111112200200021211102111121210002121110a011111101111011011222201220121a22221122222200221010101110111111100011111010110110111011111011101011
101111111111011111110111111212212121222000011100212100121aaaa111111101111111101001100111111a10100111100111101110111111111111011011010011110111001110111101110110
