146,14
1,116
87,96
60,29
112,73
35,106
118,109
83,40
39,108
77,102
1aa1111110011011111111011111111111110111101111001111111101100011111111001111101110101111111111111100011101111000011011111111110011111110111111101011011111010111
11aaaaa011101111010111100111111111011110101111100111111010001111111111111111111111110111111111111111111011110001111111111111111011110001111110111111111110011111
01aa11a111101011111111111111111110111111111111111111110111111101111111011111011111110111101101111011111111111111111111111111111111110011000100101110111111111111
01aa11a111011110111111111101111110111111111111111111110110011111011111101110011111011111111110110001111110101011101010011111111111111111111000111111101111010011
110111a111111011111011111111111111111111111011111110110100111010111111110100110111111110111111111011111110110011101110110001110110111111111111001111111111111100
111111a111aaa111111110110001111010111101111111111101000110101110111111111111011111111110110111111111110011111110011111111111111111011111100011111111101111111111
010001a111a1a010101011111111001110011111110111111111111011111111101111111111011111110011100101011111110001010011111111111010110111001111101111011110111100001011
111111a110a1aaaa101111111111010101111111101111111101011111011111011011011011110011111111111111111001111011111010110110111111101111111111110101100111011011111001
110101aa01aa011a101011111010101010111111111111101111110110111011111111111001111111110110111111010111111111000111111110110111111111110110111110111111111101111111
0001011a00aa111a101111111101111011111111110110111100110011011111111111111111011001001111101011111010111111110111011111101011111111010111100110111110111111100111
1111111a11a1111a111111110110111111110111101111111101110111110110011111111011111111011110100101111000111111111111111110110111101100111011011110111111110111111111
0111101a11a1010a111000011111111111111001101111111111010011100111111011011110111101011111011111111111110101111011011111111111011111101111011111111011101110111011
111111aa1aa1110a101011011111111111100111111111111111110111111011111111011111010101011111111111111110111111101111111111111011011011111111111111111001111111011111
010110aaaa11011a101011101011001000111110100111111101010110110101111110111100111111111101001011011111111110111001111011011010110011111111110111111111111011111110
111011111011111a101111111110111110110111111010222112000120212110122211101220110101111111110111001011111110111101101011111101110110111011111011111110011011101111
111111111111111a111111001101010011111111111112121021202221221211222001110122101101011111111111110111011110111010011111100101110110101101011101111111001010111110
101110011101111a111001011111010101010111011101121122111220221110111200122212110100111111101111111101011111010111100111111110111001100111111111111101100111111111
0111011aaaa1111aaaa111011100011111101111111111112121200021011222020011111101001111101111011111111100111111111111111111101110111111010101101010100011110111110011
0011101a11a111110aa110011111111101111100111111120221002212021001110222221102111111111010010101111011001011110111101111111111111111111111111011111101011111111011
1111011a11a111111a1110111111111111111110111111222211222002112202112221011021110101110111111111101110100110111111101110100110111000111111011111111001010011100111
0101111a10a111111a1111101111111111110011111111201222211112001122102012102021111111110111101111111111111111111110110111101111110111111111111111101111111111001101
111011aa11a11111aa0111110111101101111011011111122110210122120122111011002122101111111111100111011011111110110111111111011111111101111111011111111111110111111010
011111aaa1a01111a11110111111110110111111011112212221002112012211222110111112101111110101111111111010100111111111110111111111111011111110111111111111101010110111
11110101a0aaaaaaa10111111001111111101001111111212101222112122212211210111122110101010111110110011010111101111101110111101010111110111101101001111111011111111111
11aaaa11a1110101111101111101111111111101111111121101210112022112122002212021001111101110011101111101111111111011011111110111110011111111100101100110111111110111
1aa11a11a1001101111111111111111111111101101102220211122100111121021201112212121212202212111122102111111111111010101110110101101111111111011111111110111101111110
1a111aaaa1101111111011111100111111011011111111120211111012111222210110222020121222112021222111122211110111010111111111111111111000100101110111100111011111111011
1a11111010011011011101101111111111011111001112120121101201211111002201222220000100212220112210022221111001111011010111110011010100011111011110000111111110111101
1a10110111111111010101001111011111111111111110221102111221111221221112022021122211222122001121010200111111101001111111001110111101111011011101000111111111111111
1a11110111111111111111011110111111111101111101222102221221011211201120001220122210112100212201122121111001011111001111011111011111010110111011111011111111101111
1a11001111111111111111111101111101011011001102122112212210112001202121222220222121212201220222122120101111011101111111111111111110111101001110101110111111111110
0a11110110111111101110111001101011111111111102210121222212112112211102102121001011112112201021111121111111011111001111111011110111111011000111010111110010111111
aa11111111111110111111100101110110111011111111212011122121101110222022002012020222001112121212211201111011001101011101101101101011101101110111011001101011111111
0011110111101111010111011001010111111101010112122020211001220212212222212112021222022202121022220201111111011111010101101110001111111111011111111111111111011101
1000101111111101011111001111111111011111111112110220021222111220001222222100222021112220122002002010111111001111011111010110111111101101111011111111111100111110
1111111111111101101111011111110111100101011012212010111202001022022221122221002112001022122220212201110111010001110011011011111101101111101101011101110111110111
1111111111111111111011011100011111111101111111022120102010211021221111212220222220122110210212211120110111100111111111110110011001000111110111111111110111111110
1101111011111111011011110111011111101011111111211102222220122221210122202212110112202211121022011121111110110111110111001111011111111111110110110011011011111101
1010111111111101110111111111010111011011101111112210122022021110211100201022221222111221112222002211101011110101110110110101111110011011111110001011111101111010
1110111111111100111101111111111010111100110100010212122111102222002121002212222011111011110201122121010111111110111111101111110101101101111110111100111101111011
1111111111111111111011111111101111111101111111122222202111212102102112221102012022101022122021212211111111111110111110111110110111101011001111111111111111111110
1111011011001100110100111101111100101000010111211210102020101211121122212101011112210110122210121211101110111111111111111011111011111111111111100111111011111111
1111011101110111111111111110111110111111010112212020001201222220121222000222122211012120111001101121111011111111111111110100111111111100111111111010111110111111
1111111100111110111111111111111011110111111102221102112120021221212222212211120111222211011222102111110111111111011111101111111111111000011111001111110111111100
1011111111100111101001101111111111101111010112220122122202112212002212120112101022111110012220220120110111111101111100111110111111111111111111011111011111111111
0011111111111111111111110110110011101011111110110001100110111111111100212121220221220111012210122010110111111111111110010001111111101101011001111111001000111111
1011111110111111111111111001111010101111100111110111110110111111101122122121121102201222112202011201011111011111101111011111111111011111111010010110111111101101
1000111111111111011111101111111111111111101111111101111110011101111121101202011221122102111202211211101010111011111111110111011010101111111011111101111110110110
1110001000111111111111110110111111111111111011111111110011111111110111112000111211222212121022110211111111111101101101111111110110111111111111111111111011101111
1010101011111111010101011110011111011011111111100000111111101111111122000212110222210022120222012120111001101111111110110111001001011110100110111101111111111111
0111011111111111111101100011001011001111101011111111111011111011110121211011111120011121222201012110111111011110101101110111111111111100110111111111101111000111
1110111011111111111101111110110101111110011111111101100011011101001112011111111112221212110122221101011111111111111111111111011111110111101111010100111110101110
1111111111011101101111011101111011111110010101111111111101101110101012121011102102121112201102202021111101100111111011111011010110011011010010111101110111111111
1111011110101001110011111111101100110110111111110111111111111111110120211102120111211101001011020121111111111111110011111111111100111010100101001110111111101011
1111111111110110110111111111111111011111111011111101110111101011110101220202210020112211110221012021111010011010011110111110011111010110111111101011111101111001
1011111110001110111111111111001111011111011011111011111011111011111112120221222222222120211210112021110111111101111111111111111111011010010111110100110111110111
1111111111110111101011111111111011101101011110011111111110100111101111011111111111111111101111111101011101110111111111111001011111111110111111010110111111101101
0111101111111111110101101111001110111111111110111100111111110111100110011111111111011111111101110110011110110111111100111111111101111100100101010111101111111111
1111010011111011111111110111011010010110101110011111111111111111110101111111101111111111101101110212221222102111221210022210220111111111001011110011111111110111
0010101001011111111010111110011011111101111111111011111101010011001111110011101111101111011111011222101011221212210221021210201111111111001111110110110111111111
1011111101111001101111100111101110111000111111111011111111111110101111011111111011011111111101110101210120222121002222021122212211110111111111111111011101111010
1111111111111010101101111101101111110001011011111101111011011111101111111111111101110011101111111222212202120110102110211200021211111110111101101111101110111101
1101110010011111111010010111110111001111001111101111111101101111111111111101101001110111110010111021221111112011110210101002101011111100111110111011111100110110
1100110110110110111111001110111101011101111111011101101010110110101011001111111111011111110111111101222022112011201210120021101111000111101011011011111111010101
1100111101111111111101100110010111110101111101111111001010101010111111111111111011011111110111111021001112010220201212112012020010110111101011011101111111111011
aaa1101111111111101111001111111111011111110101011111110111111110111111110011101101111111110111101112202020022200001210211020120111010111111111111011111011001110
11aaaa001101111111101111111011111111111111010011111111101111111111110011011110111111011111000111010212210212111210121202120200021101110111111111011111111101111a
10111a111111011111111111111111111111111101111101111100111011111111011101111111111010111111011001101101201100121221121200021212011111111101110011111011111011111a
01111a111111111011111111111111111111001111011110101011111111111101110110111011101110111100111100112102021202122212121110011121010111110111111111101010101011100a
11111a111100111010011101101011111111110111101110011110111111111101111011111111111011111011111111000002022221220211101121220221220111000111110010110111011110111a
11111a111111011111111111101100111111011111011111100011111111101011111100011100111111111011111111110022222221111122121201202122111111011110101011101111111001111a
11111a001aaaaaaaaa111111101111111111111111111111110101100111111111111111111011011111111101101010101101022210202112200201212201121111101111111111001000011111101a
01101aaaaa1000111a111110111111111111111111111111111011111111011111111010111110011101101111101101012012210211110200210112011221221100101111101100111001011111111a
11001100111100111a011101111111111111001101111111111111011111110111111011100101101101011111111110101211210220011010110212221201221111111110111111111001111011111a
11111111001111111a111111001011101111100110111110111110011100110111011111111111111011110111011011112222122111222112111202112121221011101011111111110111101110aaaa
01101111011111111a111101111111011111110111111110011111111111111111001011111111101011101001010100122012211122010221222200011110121001111101101011011111111111a011
11110111111101111aaaaa1111101111111111111101110111110101010110111111111100111111011111110101101001121220101101011221010220222011111111111110110011101111111aa011
111111111110011011111a0111111111111111011101111101110111111111111111111111011011101010111111111111121121121221022201110222012201111101101111110110101011010a1111
111111101011111011111a1011010101111111101111111111111110111111110110111101111101111101111110111112021212010202201222200012221222111111111111010100111100aaaa1011
101001111010111010111aa111101101111100111111101111011101111111101111111011011111111111011111111011000222222020101102211212221211011101111111110110011001a1111111
0111111110101111110010a11111111111101111111111101101111011111101111110101111001101111110111011011012102021101122000120022201201210111110111111110101111aa1111111
1011111111010111111110aaa011011101100111111111001011111011111111011101101012112111011112112210221111021001110111100002011111211211111110101011111111111a10011110
101100111111001111001011a110101101101011111111111111111111111011111110112101110222112121021222201112220221121201012201200211121110110111011101111111011a11111111
111110111011011111111111a111111101111111111011111101111110110011111110102012002111021211212121212220202221200011220121200111011111110111111111111101111aa1111111
11111111111011011111111aa1111011011111100111111111110111111011111001111121101012200100202121101112012221221010120010212001201012100110100101110011101111a1010111
11111101011110aa1011110aaaa011111111111111011110111110111101111111110011121121120121011212011212202220211020212011212122211102221111101011011101110011aaa1111110
11111111111111aa1111011aaaa111111111111111011011111101001011111111111111110102102002222221001012022110012202120120121222110122211111111111100110111011a011010111
11101111110110aaaaaaaaaa111111111100111101111010101001111111110111122101222222202220222101221221022222220002112011121010221211101001011001111010111111a101111011
1101111111111aa111011110010111101101111111111101011100111101011011101201111222202222222120212212122221212212211010010002120010201110111101011111111110a010111111
1111110011001a1111010001100000111111001101110111100111011011112020201222222211222221212022120111201210111110011010101111001111101111001111110111010101a011111010
1011111010aaaa1001001101111111100110111111110111101011111111111222020221201002221211220210220011110120111111110111011110101011111111011111111001101110a101011111
1110111001a1011111112222011111222111202220112222201111111111111121211112221210110002122222022221210112011110101111101111111101010111001010111111111101a110111101
1111111111a1111111111101101221121011211212222111121110111111112101222111222101200112220202222121122210010111111111111110111111110111011110011111111aaaa011111110
1111111101a001010111222022222202222002211222121222012220010aa11121210220212201220221120112220122221021111111011111101101111110111011100111111111110aa01111111110
1101111111a110111111212020222210221222020112221222220020011aa1102222221221122221002202222200001101212012210122221221220212012121121102111111111aaaaaa11101111111
101110aaaaa111011101201111220220002220002222222120212020001aaaab2101121122222200222221022222220211221010121111021111011022011221121122111001111aaaa1111110111111
111101a1011101111101012212212022102212202212221102112221111a011a22121010221110212022121222101122022122011221222102100201000220002122211010001aaaaaa1010101111101
111110a1110011111011211222220210220022202200222222202221111a011b11122212212222220220010222102100112200002120212002121022101120002101211111111a111111011011011001
111001a1101011010111022211201212102220222222222212122110011aa11bba022122112212221221121201010220202121111010102102111111022002201001211011111a101111111111111111
110101a111111111011122222022222222220011222200112022011011aaa1020aaaa222111121202202222222112201010121201011122120122200111120212121121110000a111101111011111111
11aaaaa101011011111122122202220121220110022222212021222111aaaa221222b10122222222111022212002012201211121012110022202000010211102bbaaba101aaaaa000001111011111111
11a0011111111111111120222211222220222122202020002222112110111a1201bab21110122101202202220222211210121211211222111210111012012201a2112aa1aa1110111011111111101111
11a1111111101111111121200200222211222002221102210222221111111a1021abab1122212020222212020221201211211121111102202202100122121011a12222a1aa1111111011111101101111
11a11111111101111101212021120221220222222221222222211aaa01011a1012011b0202220200222202112012210122020221020211021020222112201112abb121a10aa101111111011111111110
01a11111111111000110201022020111112211022210221201122b2aaaaaaa2101200a011221221202222121222121221201111112111102200002112001102102b212aaaaa111101010011111010001
11aa1011101110110010201112120002111220012212202022201a2aa100112122120a001002122201012122022221212112021201201000012022121020000121a02201011111110111111011110101
101a1010111001101101200121022022002002012222222120020a1aaa11112121222b200222202222002011020212112212220221222222121212121112001220a01211100111011111110111001011
101a1111110110101111222001220002020221112001200002022a1aaa11101000111b222112222202012012120121020102012110011211011001122221220121b21211111111111110101111101011
111a1111111101111111011201011201200222222220122222200a2aa01011210010bb111122211110112222220222121110210121221121121000211112012202a22010101111101111111101111001
01aa0110100110110001021022022202221122122222021222022b2aa01011021211b0222222211220212202220100201121112122001212111201102220220221abb111111011011111101111111111
11a10010111111101011102122200122121221121100222121201a21101111220202b210220122222202212202221222101022210220022102010110100001111112a011111101100110111100111100
11a11001110111110111111122122222221221222021220022222a11011111121212b01aaa0220220220211222012021102121222221121022120200111212101012b211101010111111100111111111
11aaaa11111111111111211122211001201201010220222022200a21111011021102a22bba1222221012111120110100111111011101211111112221022020111101a101101111111111011010101111
a0110aa1100100101110111112222200202120220200222220201b21111010211220babba11120212212221222112111111111101100122200112211222101110020a211111011101111111011111000
aaaaaaa1111001111101111220212221222212012101221222122a210111111221011211b21112212001112221202111111101122112112101011022021000212012a111110111101110110110111011
11111111111011111101221000200021220221222112200212001b201010110122121211a22222220112012112121101110011112110011022101120122022022122a111111101111111111110011111
10111011111101111110221122102220221121222022022221122b001110102212121212a10212112002201112100111111011121222121201102122012112221211a201010001111111101101111011
10111111011111111111200212220222202222211222122200012a011110112110121102b21120122011111200221101110111012120120212212010221012221111a101111111111111111101110101
11011101111111111101002222222212221122222210211022212bb10001001001011111a11011100111111110011111111111011222121222101201121122212121a210110110111111111001101011
111111101110110011111011221222020011202120012222201111b1101010111101111aa11111101011110101110111101110111221222220101111122220022021b211111011011111111111110111
