9,11
151,105
39,62
84,90
39,50
76,91
138,69
86,65
147,116
32,7
111111111111111101212110120102022221121212210112111111111110110111110111011111111111a101111011111111001111101aaaa11111111111011110011111011011111111110111011110
111011111111111111220020012201202111111122111222110111111011111111110111111111111111a111110aaaaaaa11111111101111a11011111110110101111111111111111111111111111011
111111011111010111022121021012022022111012101211111100111110101111101101111110111111a11aaaaa11101a10001111111111a11111111111111101111111111111111001111101001111
111110111101100111111121120102001122000222012220101111101111011110011111111111111101a11aaa1111101a11100111101111a11111111111011111111110101111101111101011110111
101111111111011111212120112212010111121122102020111111011111111000111111110111100111a1111a1011111a10011111110001a00101010011110111111111110111110011101111110111
111111111011101111121120120012010212200121020120111110110111101111101101110101111110a111aa1110111a11111000aaaaaaa01011111011011110111100111111110110111110011011
101001111101101111222012001202211220111201200010111011011111111111011111010101001110a011a11001111a10110110a01101011101110111111110010111110011000111111100101010
100001111011011112222221012120201212101220120111111111111111101111011111001101111111a011a11111011a1111111aa10111111011111011111111111111101111110111111110011110
10100110100111001102211112221110222201111121121111111111111101110011111100111111111aa1aaa11010111a101011aa111111111111101011110111111100111101111111110111111111
01110111111000011201111022121021220120112111020210111111111001111111101111111111011a11aaa01111111a110001a1110111111111101110111101011000111111111110101111111101
00101111110011111200222102110212211111001112111100111110111010011011100001110111111aa1aaaa1111101a111111a1111111111110001111111111110111111111111110110011110111
101110111011111102100121221112002002102202102120111111111011111011101111111011111010a1aaaa110aa10a110111a1111111111111111111111111111111111100101101111111111111
011111100110111012111211011002002110111120211021011110111111101111001111110111111111aaa110110aaaaa110011aaa11011011111110111011111111110101111110111111101111011
111111111111111101112222110021111211221011202011111101111111111111111111110111111000100011011a111111111110a00011111111110111111111000110110101110011111111100011
011111101011101111112222202210112122201101222212011001101111111111111100111111011111110111101a011011111111a11111110111111111010111111111111111101111111111111111
111111111111111111111011221212121111012011022012111001011111110100110100111111101111010111101aaaaa111101aaa11101001111111101001111011011011000111110111111111011
1101111010111011112211201212222210102211222122201111101111101011110111011101100110010111111111111a110111a0111010111111101111100011011111100010111110011111111111
1111101101111111112110222201211201011002022100111111111101101111110101110111111111111110110110111a111111a1111100111110110010111111111111111011110111011111101111
1101111111101111012121021122021121010112102210111101110101101111011111111011111011100011011111111aaaaaa1a1011110100001101111111111111001111111110111111111111110
111111101010010102111022012012212012110101122200010111111111111110101110111010110110110100011110111111a1a1011111101111101111111111111110111111111110011111111011
101011110011101112222012102010112222001212121020101110111000110101111111101111101001110110110111011111aaa1111011010110111111111110110101110111111111111100111110
1010111aaaa11111120021220120010011221112121121210011111101110011111111111010111111110111111111101000111111011111011101011011001111111111000111101111111111101110
1111111a01a11101001201200121020112201222222222201111111001110111001111100111101111111111111001000111111111101111100111111110111101011100111100111111011111111111
1011110a10a01111111101111111110011111110101111111111110111111111111111111101111010111111111011111101110100111111111111110110101011111111111111111101111110111111
01011aaa11a11101111111111111111101101111111111111111111011110110101111111100011111001101001111111111011111111110111111110100111011011111111101101111111101011101
111aaa1111a10110111101010110111111111111010111101011111110101101011111110011111010111101001111011110111111111001011010111110101111010111111101111001111011101111
111aaa1aaaa01111111111110110001011111011101111111111111111111111111101111111100111111111111111001010101111111011111110111111011111111110111011111111111111101111
00111a1a11111110001111111111111111111011111011110110111101111011010101110111011101111100111111111011011111111000111111011111110111110110110011101111101111110110
11101aaa11111001000110111111111111100111110010111101101110111101001111111111111111111101111011011101101001111110111111111111111101111111001011101111011111111111
aaaaaaa010100111101110111011100111111111111110110111110111111111100111011011011111010111111111101101111101111100111011000111011100110111010111111111111101111111
001111a101111111111011111110111101101011111110011101111111111100111011111111011110111101111010111111111111111111101101101111110111100111110010110001010111111111
111011a010110111111011111111101011111011111110101111111111110011111001100111111111111111101110110111110111111111011111011101111111110111111111111011110101111111
010110a111111100110000011101111110110011110110111111111101111011011110111101111111101111110011111110111011101111111111111011111101110111111101111110101111101111
111111a011101110011101101111111011111001001111111111101101111101010110111101110111111001101101111101001111111101011110111111111111001111101011101101111110011011
111111a101110110111111101111010111011111110011111111111110110111110111101111111010111111101111101101111111111000011011101111011110110111011100111111111111011111
111111aa01011111011111112220121212010011020112211012222111111010110000111100111011110111111111111011001101101101111101111110111110111111100111111111111110101101
1111011a11111111011111100212022121210220110212120202122111111111011111111111010111011101111111111100111111011001111010111110111011111111110110111111110111111111
1011100a11101101110010111220112102211022022111112220121110110111100010011111011101111111111101101011011111111101011101000111111111111101111111111111101111011111
1001011a11011111011111111221021022201121021202222101001111111011110011111111000111111111111101110111111111111111111111111111100101111111111111111111011111111111
1111100aaa101001111111111212100202112212222111111222121111110011111111110101111110111111111111101111111010111011111111101111111111111101110111111011111111111110
111011100a110101111101102210112021212220002120201010211111110100101011111011110011111110111011111101111011110110111111010111111111101100110111111111111011111110
111101011a111101111110112122022122002121221212002112011110111111110100110111111010111110010011101101111111001111011111111111001111011111111111110101110101110101
101111111a111111111110111221211111210110111212101211112111111111111111111001110111011111011111111111101111101111111011111011011111111111001111001010111011101111
111111101a111101111100112200211022022121110102222102121111000111111111111011111111110110111110011101111111101110110110111001101110111111101110111111011110111111
111101111aaa1001111001111111111111222012121112011202221111111111101101011110011110101110111111101000111111101111101111111011010011111101111110111110011110111101
111110111aaa0101110111110120202100002110121211021212101111110100111101111111111101111101111111110111111110111110011111111010111101111111111111011111111101110111
101011110a101001111001101220211222222221211011000100121111110110011101110101100111101111100011011110111010111111111100100111111111100111111011011111011011110111
111111111aa01111111111112110022022220022121201022222112111110111110111101100011110111111110111010110111011011110111110111111111111111011111111111111111110111111
1101011110a11111111111111122211022222022222222222222101111111111101011111111111111111111101111011111111111011110111111011010111111111111111111111aa1111111101111
1011101111a11111111111112122001021022022220001022222212011111110111111111101101111101111111111011011011111011111011111110101011011101111011010011aa1111111101111
aa11100101a11100111111111222122020221221222222021212012111111111111110022002112122022110221022200020020111010011100110111101010100100100101010110aaa010111111111
aa11111111a10111110111112121002221201222200212221012112111110101011100121222100211122001021222101012111111111111111101111111011101011101011011100a0aaaaa11101110
aa01101101a10111111011110002220222001210221002222202121110111111110111121202221111101022222211022112211111011001111111111101111011101110011111111a11111a011aa011
aa11111011a111011111111122222222220222122100102212202211111101111011111012222111222121211212112210021211110110111101110001110100011111111111aaaaaa11111a111aaaa1
1a10111101aaa10111111110222212220122212202202022220222011101100101011112221210222021010112002111202212011111111111111110110011210101222112baa2100211202b111a11aa
0a1111011111a01010111010002222202221022220022221222220211111101111111100012222221122202111022222001101110111100111111101111222110111122212b11101211ba21bbaaa1111
1a11aaaa1110a11011110010222221212222222221202222221021011110111111111112212200222011221121111100220002111110111001111111011222210212222212abab0220bbaa2122110111
1aaaa11a1110a01110111111212202202221202201221101221202110100011010111012220212212012211210221201100222011101111111111111110102122122110022020a1020b00b2221100111
1010010a1111a11111111010202222201212022001220122102100001111110101101112102121122202101220201211021120111111101111011111101210211101012201011bbabab12a2211111011
1111111aaaaaa11100111111010122001000012222222102222112211111001111111112212212211221000012111201212121111111011110111111111011212112201120221ab21ab12ab110110011
101111111011111110001111202222021122222222212122102100000101111101111111111121222022012121111212122011111101110111001111010121222121012001202ba02bab21a101011111
1011110111111111111111112202220220210210202022212201222100111111111111100211111010100211021221121021111111111111001111011111200012012102121221220bab22a211111110
111111111111110111101011000021010222222212010221222022011110101110111112120222221210210100122111212010111000110110111000001211101012122222122111222202a222111111
111111110111111111111111210010222011222220122222202122011011110111111111122121001122112120212111201222001111101100111111111021102010011121221222012000b2201111aa
111110111111110101111110220022012202122222221022122220210111011010111110220212001122111120211110222011011100111111101111111111201211122222121221101111b2111111aa
111111111001111111000111220202201120201222210022202002011011111110101010012102201112222100212112201102111110101111010111111211221121011212102211222010b0211101a1
11011101011101010111101111022112212112212010201222010020001111011111111212102221021220022100022212201211011111101111111111112020222221212220112211211bb2011111a1
11111011111101111111111121100021102100222120112222022211111011111101111012012212112220021202220212101211010010111110101101122011211102011102010011211a02111111a1
11111111001111110110110112110220111012221122101110122010111110111011110220221210210220120001001210111211111101010101011101111122222111110112200122200b1baaaaaaa1
11101111111101111011101101121221112221012122221022021211011111111110111220001112201112222220012212101011110111111011110111120222221221122221202021111bba21111011
0011110110011111111110112200210122020122101121110110112111011111111111020202221111211022210120102220221100111011100010111111020022110221211221002221001222101111
1111111011011111111011100102212022102111222001111121212111111001111101011011200221200101212212122111021111101011001100011112100220102021121220022021021022111110
1011101111111110111101102101122022010102211112020212202111101111011111122221221101110121121222122112221110111110111101100011212102211101021212111201200211111110
1111101111111111011111102112101121111112012020022111112011111111010010122022102112110102012002110211111011011110111111111111112022112102121211122111120211111010
1101101100111110011111112010111211221120122202212120022110111111011011111010022220211011101212210000221101101111111111010111220211100112100222122022211100111101
0111111101111111111011112111020212211021210212110222111100110111101112220221121222222211122220202001221111110111110111101101102002221221120221111202222020111101
0111000111011111101101102022120221122001122220222200102101011202121122202220000212222202221222112112200101111001110101011111202111000122110120110101211112101010
1111101110111101110110111221211112102022201201221021220111111211111222022202202220020022222222222012210111011011011101011111110112010002011212022022111221111111
0110101111110111111110011111011110001111101111100111111110111221022122200001222202222222220212221221211101111111010111111111220221111012120110011022020120111000
1111110000110110111111011101111111111101110111010101111110110120212110221121222002222222222220212212201001111010101101011111121200110012011222012212112221100110
1110101011010111111011111111110111111111000011111100111011011200220102201201022222021021220021212002201111011111111101010112021200022122111112200102000112111111
0101111101111011101100110111011111111011111111101111111010101221021002202010022121102200010202221001011111101011110111001112112011212112222222021021110112101111
1111000011111011111101110111010101010111111011111111011111111222110010221221221021012222222121121221111001111111110111100111200222212100212122201200112002110111
1111011111101111111010101111101011101101110110111111111111011212112112222222101222111120122221120220111111100001111101111102112010222201221100112222221122011011
1011111111111111111111011110111101111011111111011001110101110222122222122101220221000222022211200111111111011111111100010112222001001202112202002112120001111111
11101aaaa1111111011011111111111010111101110110011101111111111222220010221112212212222112012202112022111111110111011111111111011110111111101110000110111111101011
aaaaaa10a0111011111111110111111101101111011111111011111011110021112221220220002222211202222112101212100111110111111111111110011111111111110010110111011110100110
11111110a0111111000101100100111111111111111111111011111111111022212102122221212202220212212121210212101111111011111101101011101100111011011111110111111111101111
11111010aa011111011101111101001011111111111111110111110111111112221121022211022222222022222112222112011111101100101111111110111111101110111110011011111111011111
110110100a011111111010100111111101101111111111110111111001111212212112212212212222021020102212102112111111111101111111111111111110111111111111111111111010110110
111011001aaaa111111011110110111110111111110101101111000111101002212212220022221212212212022222201022011011101110110111111101111111011111001100100111111111101111
111111110010aa11111011111111111111111111101101110111111111110121111222221021112222210021002010222222111111011111110111101111001111111111101111111111111110110101
1111001111010a11111010111111100001111111010111011111110010111212122122020222022002221102121202211221011101111111111100111111111111011101011111111010111110111110
1101111111001a01100111111111111111110111011100100011111111111220112100202222001101221022220211011220111110111111111111011110111001111101110111110111101011011001
1111010111111a11010101011101110111111111011011010001111001111101121112222221222202112222220012001122111100111111111111111111011101111010011111111111111101111111
1111111111111a01101011101110111000111111111111101111001111101112211202002212120220222222222122020012110111110111011111111101101011101111110011111111101110101111
1111011111101a01111111010101111111111111110111110010011011110022012112022122202212012212001221220210110011011101111111111111011010111111111110111101111011111111
1011111111011a11111111111111110110101000101111011111110111111111121102210222210212220000222221211210110100111111111101111110111101101101111110110111111100011111
11011111111aaa11111101100110111111111001111111100010110011111121122122012102220222211221110211212111110111110111111111111011111111101110111101111101111111110111
10111111aaaa1011110111111111110100100110100111110111110111111211020021201222022212102222222001120211111110111110001111111111001011011101011111111111111101011001
10110110a1111111010111111111011011011100001111111011111110111112021122020222220202022122020201102221101110111011111101111101011101111111011001101001101110111111
10011111aaa11110011001111110110111110101101110111111111011110001202222122022222002122201221101120120000111101101111101101011111111100120110201210122221011212120
1011111110a11111111111001111111100110111101111110101010110110220212112220212112222222201222221112011111111111011111110111110111111111212222201212011002021221000
1101111111a11111011011110111111110111111011100011111101101010202112212222022010022222220202002000001010011110001111111110111111111001021122221002221220210222201
1111101111aaaa10011011011110110101101101111101001110010111111221102212222012222012121102222002111010111101101111011111111111000111001010111021022111011211212121
1111010110000a11110111111111111011110111011101101001011001101200222112021222200222220100122020200210111011010111111111011110110111111102122000221221202022122022
1101000111111a11111111111111010111011111111001110111111111111120210120010111212122111122222110011100101110110010101111111111010011111120002021022112212211102110
1111111111111a11111111111101111111011111010110111111010101011111111111111101100111111110111111110111011011110010111010110111101111112010020101222011020101100012
1110011011111aaaaaa111111000111111011111111111111110111111111111010101111011111111111111111101101101000101111111111111111100111111111001011102100022101020200200
01110111011aaaa111aaaaaa1aa0111011011111011111110010001101110110111111101011101111100111111111111011101111111101001110111111111111012012121221101221021011102202
11111011110aaaa10111101a1aa1111111111111111011101111101111011110111111111011111111111111011110111011101110101011111101110111100100002211201020211101111120112122
11111111000111111111010aaaa1101111011111110011111111111110111110111111101111110101111111100111111011111010111010111101111111110111111200222022121021021102011002
111010011111101111111101aaa0101101011111111111111011100111110110111100111111111111110111011001011111001111011111111111111110110011111221021110200102011111110102
11111001111110111111111111aaaaaa11101101111111111101011111101111111111111011111111111011111111011110110111111011111111101101101111112111002112120120212121220112
01111100111110101111111111aa111a11111111111110101111111011010111110111111011110011111110110111111010111111111111101111111111110010010121120010211120020120122210
11111110001111111111111111aa110aaaaaaa11111001101111001111110111011111111111011111011011111111111111110100101111101011110111111000001111212112002202211110111112
1111011011110111111111111100110100100aaa111111001110110111010101100101111111011111110111111011100111110011111111110111111111011110010202222110122201201021122102
110110101111111101011111011101110111111a110111111111010001111111111011111010111110101011101110011111111111111111111111111110111111111212012112112211112021001111
11111111110110111101001101111101011111aa111111111111101110010111101101111110011101111111111010101101101111101011011111111111101111111010112100212022222012211010
11101001101111111111111001111001111111aa111110100101101111111001111111111111011011110001111011111111101111111111000111111111111111110010122102222112022101012212
